septum position,elongation rate (1/hour),initiation size per ori (micron),tau_cyc (minute),B period (minute),C period (minute),D period (minute),division size (micron),newborn size (micron),generation time (minute),added size (micron),cell width (micron),cell ID,daughter ID
0.4419,0.4392,1.5654,70,55,35,35,2.795,1.1718,125,1.6232,0.5555,1138036,1138061
0.4594,0.5218,1.1718,80,15,50,30,2.5507,1.235,95,1.3157,0.5582,1138061,1138080
0.4543,0.4792,1.43,75,40,40,35,2.8614,1.1772,115,1.6842,0.5671,1138143,1138166
0.4741,0.4747,1.495,65,20,45,20,2.4718,1.3,85,1.1718,0.5596,1138166,1138183
0.5238,0.4851,1.4315,75,25,50,25,2.7331,1.1718,100,1.5613,0.5602,1138183,1138203
0.4547,0.3216,1.8861,70,50,50,20,3.0017,1.43,120,1.5717,0.5189,1160029,1160053
0.5258,0.416,1.4315,70,35,55,15,2.6079,1.365,105,1.2429,0.5454,1160053,1160074
0.491,0.3315,2.0317,60,65,45,15,2.9396,1.43,125,1.5096,0.5088,1160184,1160209
0.511,0.3513,1.7562,70,20,50,20,2.9365,1.7012,90,1.2353,0.5465,1168050,1168068
0.4854,0.3666,1.8895,75,45,45,30,2.9489,1.5006,120,1.4483,0.5578,1168068,1168092
0.4654,0.3814,1.6263,70,35,50,20,2.8071,1.4315,105,1.3756,0.6099,1168092,1168113
0.5641,0.3687,1.4964,75,35,55,20,2.535,1.3065,110,1.2285,0.5773,1168113,1168135
0.49,0.4723,1.7598,65,45,40,25,3.1864,1.43,110,1.7564,0.5955,1168135,1168157
0.4991,0.4551,1.695,80,5,50,30,3.1254,1.5614,85,1.5641,0.5664,1168157,1168174
0.487,0.4022,1.625,70,15,50,20,2.6728,1.56,85,1.1128,0.586,1168174,1168191
0.5013,0.342,1.5654,90,45,55,35,2.8791,1.3016,135,1.5775,0.6057,1168191,1168218
0.4747,0.4187,1.5614,80,30,45,35,2.8886,1.43,110,1.4586,0.5671,1175065,1175087
0.4767,0.3702,1.56,80,30,50,30,2.7578,1.3712,110,1.3866,0.5654,1175087,1175109
0.5248,0.367,1.7562,70,60,50,20,2.613,1.3145,130,1.2985,0.5606,1175109,1175135
0.5372,0.2918,1.6912,80,45,50,30,2.5437,1.3712,125,1.1726,0.5635,1175135,1175160
0.5235,0.3236,1.6912,85,50,55,30,2.7316,1.3665,135,1.3651,0.5692,1175160,1175187
0.5041,0.3357,1.5614,85,35,55,30,2.8834,1.43,120,1.4534,0.5677,1175187,1175211
0.5227,0.2734,1.8861,80,80,50,30,2.86,1.3145,160,1.5455,0.5156,1183042,1183074
0.4884,0.3774,1.625,75,25,50,25,2.798,1.495,100,1.303,0.5036,1183074,1183094
0.456,0.3278,1.82,70,60,45,25,2.9967,1.3665,130,1.6302,0.5018,1183094,1183120
0.4878,0.3753,1.625,80,35,55,25,2.6682,1.3665,115,1.3016,0.4965,1183120,1183143
0.4442,0.358,1.56,75,50,55,20,2.9263,1.3016,125,1.6247,0.5017,1183143,1183168
0.4855,0.3107,1.495,90,35,75,15,2.4136,1.3,125,1.1136,0.5172,1183168,1183193
0.5272,0.35,1.755,65,40,40,25,2.6156,1.4359,105,1.1797,0.5823,1191030,1191051
0.4772,0.461,1.5614,70,30,40,30,2.738,1.3789,100,1.3591,0.5702,1191051,1191071
0.5009,0.4253,1.5614,70,35,55,15,2.6081,1.3065,105,1.3016,0.5731,1191071,1191092
0.5258,0.3466,1.5654,80,50,55,25,2.6079,1.3065,130,1.3014,0.5651,1191092,1191118
0.4648,0.343,1.5614,80,45,55,25,2.6718,1.3712,125,1.3006,0.5658,1191118,1191143
0.5139,0.3889,1.5654,70,30,50,20,2.4067,1.2418,100,1.1649,0.5831,1191143,1191163
0.5333,0.4561,1.755,55,60,40,15,2.9279,1.2367,115,1.6912,0.6065,1191163,1191186
0.4875,0.498,1.8212,65,30,45,20,3.3362,1.5614,95,1.7748,0.5804,1191186,1191205
0.443,0.3598,1.885,60,50,50,10,2.8224,1.3665,110,1.4559,0.5476,1198033,1198055
0.4979,0.3077,1.7658,85,65,55,30,3.0027,1.2503,150,1.7524,0.5606,1198055,1198085
0.4616,0.3616,1.625,60,40,45,15,2.5384,1.495,100,1.0434,0.5672,1198085,1198105
0.4855,0.3371,1.9543,75,75,40,35,3.1255,1.1718,150,1.9536,0.5535,1198105,1198135
0.5234,0.2983,1.6263,85,40,55,30,2.8672,1.5174,125,1.3497,0.5554,1198135,1198160
0.5,0.3368,1.7562,70,50,50,20,2.7331,1.5006,120,1.2325,0.5673,1198160,1198184
0.5118,0.3603,1.69,75,45,55,20,2.9321,1.3665,120,1.5656,0.5631,1198184,1198208
0.4863,0.3825,1.495,85,30,50,35,2.5432,1.2367,115,1.3065,0.5313,1206042,1206065
0.5015,0.3584,1.5654,65,40,45,20,2.3472,1.2367,105,1.1105,0.5164,1206065,1206086
0.4872,0.3177,1.5721,80,55,55,25,2.535,1.1772,135,1.3578,0.5193,1206086,1206113
0.5,0.3488,1.5654,85,30,55,30,2.6032,1.235,115,1.3682,0.5407,1206113,1206136
0.4895,0.4001,1.5614,70,45,45,25,2.8012,1.3016,115,1.4996,0.5346,1206136,1206159
0.5212,0.3676,1.5614,85,20,60,25,2.769,1.3712,105,1.3978,0.5175,1206159,1206180
0.5033,0.3728,1.5721,70,30,45,25,2.7607,1.4432,100,1.3175,0.5179,1206180,1206200
0.5,0.3377,1.5654,75,50,60,15,2.5006,1.3665,125,1.1341,0.5027,1213113,1213138
0.5105,0.3261,1.7562,65,100,55,10,2.6857,1.2503,165,1.4354,0.5165,1213138,1213171
0.4281,0.3194,1.4964,95,45,75,20,2.7372,1.365,140,1.3722,0.5363,1221038,1221066
0.4728,0.4261,1.5614,70,40,55,15,2.6156,1.2418,110,1.3737,0.546,1221187,1221209
0.5134,0.2154,1.7012,90,45,65,25,2.419,1.3665,135,1.0525,0.5271,1228069,1228096
0.4394,0.3639,1.6912,70,70,60,10,2.6668,1.2418,140,1.425,0.5274,1228096,1228124
0.5248,0.3992,1.69,70,70,50,20,2.7359,1.1718,140,1.5641,0.5413,1228124,1228152
0.4986,0.4123,1.4315,70,30,50,20,2.75,1.4359,100,1.3141,0.5667,1228152,1228172
0.4859,0.4221,1.5006,75,30,50,25,2.5415,1.3712,105,1.1703,0.5833,1228172,1228193
0.4643,0.466,1.56,70,40,45,25,2.8141,1.235,110,1.5791,0.5703,1228193,1228215
0.4597,0.4373,1.4315,85,25,55,30,2.6902,1.17,110,1.5202,0.5754,1236082,1236104
0.4755,0.4056,1.625,70,50,50,20,2.7375,1.2367,120,1.5008,0.5617,1236104,1236128
0.5,0.3842,1.56,60,45,40,20,2.47,1.3016,105,1.1684,0.5692,1236128,1236149
0.5693,0.33,1.7012,60,55,40,20,2.6358,1.4359,115,1.1999,0.5491,2010084,2010107
0.6091,0.3426,1.495,70,30,50,20,2.5812,1.5006,100,1.0806,0.5558,2010107,2010127
0.5416,0.4597,1.6263,100,15,55,45,3.1227,1.4315,115,1.6912,0.5645,2032140,2032163
0.5596,0.3348,1.6263,80,40,45,35,3.2605,1.6912,120,1.5693,0.5617,2032163,2032187
0.5536,0.3651,1.755,80,25,45,35,3.0615,1.8246,105,1.2369,0.563,2032187,2032208
0.5,0.3581,1.625,85,30,55,30,2.8718,1.4359,115,1.4359,0.5776,2055085,2055108
0.5276,0.3549,1.885,70,20,40,30,2.8364,1.4359,90,1.4005,0.5485,2055108,2055126
0.5122,0.3849,1.69,80,40,45,35,2.6682,1.4964,120,1.1718,0.549,2055126,2055150
0.5128,0.3766,1.3712,85,40,45,40,2.8144,1.3665,125,1.4479,0.5512,2055150,2055175
0.474,0.4562,1.3016,70,25,50,20,2.4837,1.4432,95,1.0404,0.5485,2055175,2055194
0.4892,0.3495,1.8861,90,30,40,50,3.457,1.7562,120,1.7008,0.5517,2070168,2070192
0.4463,0.359,1.9511,95,25,40,55,3.2042,1.6912,120,1.5129,0.5474,2070192,2070216
0.5119,0.3884,1.5006,65,75,45,20,2.7965,1.2367,140,1.5598,0.5309,2078113,2078141
0.63,0.3865,1.755,50,40,45,5,2.4846,1.4315,90,1.0532,0.5263,2078141,2078159
0.4794,0.3538,2.08,60,30,40,20,3.3921,1.8304,90,1.5617,0.5088,2093037,2093055
0.5578,0.3287,1.9597,60,30,45,15,2.7967,1.6263,90,1.1704,0.5086,2093150,2093168
0.4728,0.2872,1.7012,75,25,50,25,2.6156,1.56,100,1.0556,0.487,2093168,2093188
0.4673,0.3396,1.7012,85,55,55,30,2.951,1.2367,140,1.7143,0.5055,2093188,2093216
0.5615,0.3737,1.8212,65,40,45,20,2.8165,1.5006,105,1.3159,0.544,2100065,2100086
0.5101,0.4033,1.755,75,40,45,30,3.1956,1.5815,115,1.6141,0.5329,2100086,2100109
0.6197,0.3961,1.43,80,20,55,25,2.735,1.6302,100,1.1048,0.5373,2100109,2100129
0.551,0.3174,1.6263,90,30,60,30,2.7541,1.695,120,1.0592,0.5392,2100129,2100153
0.5116,0.3543,1.7598,75,40,50,25,2.798,1.5174,115,1.2806,0.5404,2100153,2100176
0.5122,0.352,1.6912,75,40,50,25,2.6682,1.4315,115,1.2367,0.54,2100176,2100199
0.4709,0.3217,1.8212,70,25,45,25,2.9509,1.6457,95,1.3052,0.5291,2108034,2108053
0.5852,0.3164,1.3665,85,45,50,35,2.356,1.3016,130,1.0544,0.5197,2115169,2115195
0.501,0.3784,1.9511,60,50,40,20,2.8659,1.495,110,1.3709,0.5438,2123125,2123147
0.4875,0.3852,2.146,60,65,35,25,3.3362,1.4359,125,1.9003,0.5588,2123147,2123172
0.5113,0.365,1.7562,80,20,50,30,2.9264,1.6263,100,1.3001,0.5614,2123172,2123192
0.4763,0.3827,1.6263,70,30,45,25,2.8656,1.43,100,1.4356,0.5729,2130133,2130153
0.5473,0.3742,1.8212,60,40,35,25,2.7317,1.365,100,1.3667,0.5053,2145153,2145173
0.4906,0.3775,1.695,55,45,40,15,2.6795,1.495,100,1.1845,0.52,2145173,2145193
0.5094,0.3781,2.0244,55,70,40,15,3.0731,1.2503,125,1.8228,0.518,2176029,2176054
0.5392,0.2998,1.6263,65,45,50,15,2.543,1.3016,110,1.2414,0.5175,2183093,2183115
0.5525,0.2985,1.625,65,60,50,15,2.4735,1.3712,125,1.1023,0.5396,2183115,2183140
0.5437,0.3472,1.7562,55,50,50,5,2.4384,1.3665,105,1.0718,0.5337,2183140,2183161
0.5454,0.3769,1.69,80,20,50,30,2.863,1.625,100,1.238,0.5468,2198033,2198053
0.5123,0.3317,1.755,80,40,60,20,3.0686,1.5614,120,1.5072,0.5255,2198053,2198077
0.5007,0.2431,2.015,90,60,55,35,2.9971,1.5721,150,1.4249,0.5215,2198077,2198107
0.4667,0.3426,1.56,85,30,60,25,2.9279,1.5006,115,1.4273,0.5269,2198107,2198130
0.4981,0.3449,1.8212,65,40,45,20,2.7684,1.5654,105,1.203,0.5315,2206047,2206068
0.5219,0.3816,1.8895,75,55,40,35,3.1533,1.3789,130,1.7745,0.531,2206068,2206094
0.4876,0.3716,1.6302,65,25,50,15,2.8024,1.6457,90,1.1568,0.5341,2206094,2206112
0.5348,0.2769,2.015,85,70,45,40,3.1246,1.3665,155,1.758,0.5572,2206112,2206143
0.503,0.3402,2.016,65,55,45,20,3.272,1.6711,120,1.6008,0.5637,2206143,2206167
0.5308,0.3528,1.8951,65,70,45,20,2.9389,1.4359,135,1.503,0.543,2213045,2213072
0.4663,0.3765,1.9511,60,55,45,15,3.0667,1.56,115,1.5067,0.5615,2213072,2213095
0.4906,0.3936,1.755,65,30,50,15,2.8103,1.43,95,1.3803,0.5563,2213095,2213114
0.4843,0.371,1.69,70,60,45,25,2.8184,1.3789,130,1.4396,0.5683,2213114,2213140
0.5266,0.3846,1.5614,80,35,55,25,2.7599,1.365,115,1.3949,0.5932,2213140,2213163
0.5323,0.2782,1.6912,70,40,45,25,2.5172,1.7012,110,0.816,0.5613,2221100,2221122
0.4774,0.3673,1.7012,90,45,55,35,3.008,1.1718,135,1.8362,0.5567,2236108,2236135
0.466,0.3547,1.8212,80,45,50,30,3.0816,1.4359,125,1.6457,0.5587,2236135,2236160
0.5442,0.3205,1.8304,90,75,60,30,3.1146,1.2621,165,1.8525,0.5355,2244045,2244078
0.5208,0.4215,1.69,75,25,45,30,3.2666,1.5654,100,1.7012,0.6171,3040033,3040053
0.4612,0.2495,2.0192,70,55,55,15,2.9054,1.56,125,1.3454,0.5239,3040163,3040188
0.5291,0.3292,1.8212,80,5,50,30,2.9509,1.8951,85,1.0558,0.6749,3062079,3062096
0.4673,0.3042,1.695,150,35,50,100,4.0339,1.5614,185,2.4726,0.6524,3062096,3062133
0.4681,0.5212,1.7878,70,170,40,30,3.0578,1.885,55,1.1728,0.6503,3062133,3062144
0.5009,0.4079,2.081,70,15,45,25,3.3962,1.9511,85,1.4451,0.5897,3070108,3070125
0.5678,0.298,1.8861,80,25,55,25,2.8617,1.7012,105,1.1605,0.5927,3070125,3070146
0.4869,0.3162,1.9597,85,30,55,30,3.207,1.625,115,1.582,0.5815,3070146,3070169
0.5239,0.3911,1.6912,75,45,50,25,2.8963,1.5614,120,1.3349,0.5763,3070169,3070193
0.5394,0.3546,1.82,85,40,45,40,3.1332,1.5174,125,1.6158,0.5656,3070193,3070218
0.5,0.366,1.8895,75,35,50,25,3.0013,1.6367,110,1.3646,0.5753,3093054,3093076
0.5087,0.3955,1.8895,70,40,50,20,3.069,1.5006,110,1.5684,0.5627,3093076,3093098
0.5199,0.3821,1.7658,70,25,45,25,2.7616,1.5614,95,1.2003,0.5565,3093098,3093117
0.5392,0.3575,1.5614,70,30,45,25,2.543,1.4359,100,1.1071,0.5615,3093117,3093137
0.5111,0.4162,1.8212,65,70,50,15,2.9279,1.3712,135,1.5567,0.5616,3093137,3093164
0.4777,0.4264,1.8861,55,45,35,20,2.9969,1.4964,100,1.5005,0.5276,3093164,3093184
0.5162,0.3773,1.5654,75,5,55,20,2.4221,1.4315,80,0.9906,0.5555,3093184,3093200
0.5109,0.4036,1.4964,85,40,60,25,2.9265,1.3789,125,1.5476,0.5828,3100029,3100054
0.5105,0.3263,1.9597,65,40,50,15,2.8012,1.495,105,1.3062,0.5431,3100054,3100075
0.5523,0.3792,1.9597,60,50,40,20,3.1973,1.4534,110,1.7438,0.5435,3100180,3100202
0.5122,0.2712,1.8212,75,50,55,20,2.6682,1.495,125,1.1732,0.5365,3108061,3108086
0.5111,0.1767,2.016,65,155,45,20,2.9279,1.3665,220,1.5613,0.5307,3108086,3108130
0.4667,0.332,1.8212,85,25,55,30,2.925,1.4964,110,1.4286,0.525,3108130,3108152
0.5258,0.3013,1.885,60,55,45,15,2.6079,1.365,115,1.2429,0.5152,3108152,3108175
0.523,0.3361,2.015,60,65,45,15,2.8614,1.3712,125,1.4902,0.5017,3108175,3108200
0.4992,0.3826,1.8951,65,35,45,20,2.7377,1.3712,100,1.3665,0.5258,3123033,3123053
0.5245,0.4106,1.4964,80,35,50,30,2.7375,1.3665,115,1.371,0.5569,3123053,3123076
0.5122,0.4067,1.8304,65,40,45,20,2.9436,1.4359,105,1.5077,0.5363,3123076,3123097
0.5385,0.4059,1.5614,75,15,55,20,2.6799,1.5077,90,1.1723,0.5588,3123097,3123115
0.4992,0.4151,1.8304,70,30,45,25,3.2552,1.4432,100,1.812,0.5264,3123115,3123135
0.4831,0.4346,1.7598,70,15,55,15,3.1666,1.625,85,1.5416,0.5409,3123135,3123152
0.5458,0.4026,1.9543,70,25,45,25,3.036,1.5299,95,1.5061,0.553,3123152,3123171
0.5647,0.449,1.4315,70,5,50,20,2.5559,1.6572,75,0.8987,0.5746,3123171,3123186
0.4762,0.3565,1.495,80,40,50,30,2.7331,1.4432,120,1.2899,0.5835,3123186,3123210
0.4899,0.42,1.3665,70,20,55,15,2.5519,1.4359,90,1.116,0.5194,3130129,3130147
0.5348,0.3685,1.7012,75,80,45,30,2.798,1.2503,155,1.5477,0.5382,3130147,3130178
0.4552,0.3858,1.7562,70,40,45,25,2.7467,1.4964,110,1.2503,0.5408,3130178,3130200
0.5127,0.3425,1.82,70,45,50,20,2.8009,1.4432,115,1.3577,0.5113,3153144,3153167
0.4879,0.3754,2.016,60,55,45,15,2.9306,1.4359,115,1.4947,0.513,3153167,3153190
0.4762,0.4195,1.69,60,30,45,15,2.7331,1.43,90,1.3031,0.5327,3153190,3153208
0.5791,0.3883,1.6302,80,45,40,40,2.9379,1.4315,125,1.5064,0.5024,3160032,3160057
0.4545,0.3484,1.8895,80,25,60,20,3.0168,1.7012,105,1.3156,0.515,3160057,3160078
0.5,0.4623,1.495,65,30,50,15,2.73,1.3712,95,1.3588,0.527,3160078,3160097
0.5007,0.461,1.6912,70,40,40,30,2.9971,1.365,110,1.6321,0.5328,3160097,3160119
0.5116,0.4477,1.56,70,20,45,25,2.798,1.5006,90,1.2974,0.5398,3160119,3160137
0.4661,0.4766,1.69,55,30,40,15,2.8029,1.4315,85,1.3714,0.5571,3160137,3160154
0.4785,0.4812,1.43,80,20,50,30,2.9915,1.3065,100,1.685,0.5616,3160154,3160174
0.4709,0.4537,1.6912,60,35,50,10,2.9509,1.4315,95,1.5194,0.5319,3160174,3160193
0.4287,0.4217,1.56,75,25,60,15,2.8807,1.3895,100,1.4911,0.526,3160193,3160213
0.4742,0.4243,1.7562,55,60,45,10,2.7449,1.2418,115,1.503,0.5135,3168045,3168068
0.4665,0.4209,1.625,60,45,45,15,2.6803,1.3016,105,1.3787,0.5338,3168068,3168089
0.5245,0.3941,1.6912,65,45,45,20,2.7375,1.2503,110,1.4872,0.537,3168089,3168111
0.5014,0.3752,1.4359,85,10,65,20,2.4768,1.4359,95,1.0409,0.5423,3168111,3168130
0.4466,0.455,1.8895,55,35,45,10,3.0562,1.3665,90,1.6897,0.5479,3176036,3176054
0.5105,0.4114,1.5614,65,30,45,20,2.8012,1.365,95,1.4362,0.5706,3176054,3176073
0.5037,0.3658,1.8246,70,40,45,25,2.6322,1.43,110,1.2022,0.5636,3176073,3176095
0.4723,0.3158,1.43,85,30,60,25,2.3436,1.3257,115,1.0179,0.5686,3176095,3176118
0.4846,0.3785,1.495,75,70,50,25,2.82,1.1069,145,1.7131,0.5756,3176118,3176147
0.5357,0.4065,1.5721,80,15,50,30,2.8141,1.3665,95,1.4476,0.5498,3176147,3176166
0.4517,0.4034,1.7598,60,30,45,15,2.7495,1.5077,90,1.2418,0.5196,3176166,3176184
0.4755,0.349,1.56,80,55,55,25,2.7375,1.2418,135,1.4957,0.5207,3183144,3183171
0.5013,0.4221,1.5654,75,25,55,20,2.8791,1.3016,100,1.5775,0.5182,3183171,3183191
0.4762,0.3975,1.6263,70,35,50,20,2.73,1.4432,105,1.2868,0.5274,3183191,3183212
0.4762,0.3696,1.6263,70,50,45,25,2.7331,1.3665,120,1.3666,0.578,3191022,3191046
0.4394,0.3794,1.43,85,35,55,30,2.5536,1.3016,120,1.2519,0.5555,3191046,3191070
0.4949,0.4068,1.365,85,40,55,30,2.4988,1.1221,125,1.3767,0.5439,3191070,3191095
0.4518,0.3526,1.625,70,65,45,25,2.7374,1.2367,135,1.5006,0.5402,3191095,3191122
0.5365,0.4083,1.56,75,50,50,25,2.6682,1.2367,125,1.4315,0.5583,3191122,3191147
0.5127,0.361,1.5614,90,30,50,40,2.8009,1.4315,120,1.3694,0.5586,3191147,3191171
0.5015,0.426,1.4315,80,20,45,35,2.621,1.4359,100,1.1851,0.5686,3191171,3191191
0.5136,0.4386,1.5654,75,30,40,35,2.8098,1.3145,105,1.4952,0.575,3191191,3191212
0.537,0.315,1.3665,85,35,65,20,2.4237,1.3016,120,1.1221,0.5324,3198043,3198067
0.5,0.3578,1.495,75,40,45,30,2.6,1.3065,115,1.2935,0.5871,3221069,3221092
0.4997,0.3862,1.5721,75,35,45,30,2.7315,1.4534,110,1.2781,0.5691,3221187,3221209
0.4742,0.4116,1.5614,65,65,55,10,2.6079,1.17,130,1.4379,0.4962,3228076,3228102
0.4765,0.424,1.6263,65,60,50,15,2.7316,1.2367,125,1.4949,0.5129,3228102,3228127
0.5003,0.4065,1.695,70,20,55,15,2.8615,1.4964,90,1.3651,0.5892,3236027,3236045
0.5272,0.3686,1.69,65,30,50,15,2.6156,1.4315,95,1.1841,0.5632,3236045,3236064
0.513,0.2453,1.7598,80,50,55,25,2.6728,1.4534,130,1.2194,0.5065,3243076,3243102
0.4868,0.313,1.9597,70,65,45,25,2.9377,1.3712,135,1.5665,0.5132,3243102,3243129
0.5008,0.2925,1.7598,80,35,60,20,2.7377,1.43,115,1.3077,0.5089,3243129,3243152
0.4981,0.3522,1.8212,65,50,45,20,2.7684,1.3712,115,1.3972,0.4939,3243152,3243175
0.4865,0.3566,1.6367,75,35,55,20,2.6853,1.3789,110,1.3065,0.513,3243175,3243197
0.4613,0.3311,1.6302,75,35,55,20,2.5365,1.3065,110,1.2301,0.5312,3243197,3243219
0.4869,0.3037,1.695,75,75,50,25,2.5366,1.1352,150,1.4014,0.5133,3251072,3251102
0.4606,0.3924,1.5006,80,25,55,25,2.5561,1.235,105,1.3211,0.5464,3251102,3251123
0.5,0.3104,1.695,80,70,45,35,2.6291,1.1772,150,1.4519,0.5369,3251123,3251153
0.5,0.3635,1.3665,80,25,50,30,2.5006,1.3145,105,1.1861,0.5512,3251153,3251174
0.4645,0.4058,1.6263,65,55,50,15,2.8023,1.2503,120,1.552,0.5458,3251174,3251198
0.5383,0.3391,1.8895,70,60,40,30,2.8191,1.495,130,1.3241,0.6407,4019078,4019104
0.4881,0.4261,1.6367,80,30,55,25,2.7965,1.3,110,1.4965,0.627,4019175,4019197
0.5358,0.3609,1.7012,70,35,45,25,2.6935,1.4964,105,1.1971,0.5794,4026043,4026064
0.4854,0.3679,1.56,95,35,55,40,2.9489,1.4432,130,1.5057,0.5823,4026064,4026090
0.5355,0.4414,1.6263,65,20,40,25,2.6733,1.4315,85,1.2418,0.5937,4026090,4026107
0.4755,0.4044,1.6263,75,40,45,30,2.8742,1.4315,115,1.4427,0.5695,4026107,4026130
0.4988,0.4212,1.4964,75,25,50,25,2.6065,1.3665,100,1.2399,0.5774,4026130,4026150
0.4824,0.3736,1.7562,70,55,45,25,2.833,1.3,125,1.533,0.5714,4026150,4026175
0.4793,0.4568,1.6263,85,30,45,40,3.1308,1.3665,115,1.7643,0.5689,4026175,4026198
0.497,0.4756,1.6302,70,10,50,20,2.8893,1.5006,80,1.3887,0.5631,4026198,4026214
0.4939,0.3495,2.0244,75,40,45,30,3.0527,1.5614,115,1.4913,0.6127,4042046,4042069
0.5539,0.3795,1.6912,70,35,45,25,3.06,1.5077,105,1.5523,0.6045,4042069,4042090
0.455,0.3835,1.8246,70,15,45,25,3.0032,1.695,85,1.3082,0.6155,4042090,4042107
0.5,0.4178,1.6302,85,15,45,40,2.9928,1.3665,100,1.6263,0.6295,4042107,4042127
0.5346,0.3528,1.56,90,25,45,45,2.7966,1.4964,115,1.3002,0.6173,4042127,4042150
0.5373,0.2945,1.8212,70,60,40,30,2.6726,1.5077,130,1.1649,0.5387,4049169,4049195
0.531,0.3554,1.69,75,20,40,35,2.9402,1.7012,95,1.239,0.6113,4064034,4064053
0.4972,0.3253,1.8212,75,75,55,20,3.0181,1.3145,150,1.7035,0.5744,4087183,4087213
0.5019,0.2987,1.8861,65,100,45,20,2.7684,1.2418,165,1.5266,0.59,4094039,4094072
0.4734,0.3684,1.9597,60,60,40,20,2.7599,1.3895,120,1.3704,0.5824,4094072,4094096
0.4879,0.3635,1.7598,70,45,50,20,2.6777,1.3065,115,1.3712,0.5875,4094096,4094119
0.4978,0.455,1.5654,75,40,55,20,2.7454,1.3065,115,1.4389,0.5728,4094119,4094142
0.5304,0.369,1.5654,85,5,60,25,2.3572,1.3665,90,0.9907,0.5643,4094142,4094160
0.4876,0.3602,1.43,90,50,55,35,2.8024,1.2503,140,1.5521,0.5601,4094160,4094188
0.5105,0.3107,1.695,80,60,60,20,2.8012,1.3665,140,1.4346,0.5541,4094188,4094216
0.5441,0.4128,1.7598,70,35,40,30,3.0245,1.4359,105,1.5886,0.5834,4102133,4102154
0.4881,0.3807,1.8246,60,15,45,15,2.6934,1.6457,75,1.0477,0.5572,4102154,4102169
0.4398,0.408,1.7658,70,35,50,20,2.8233,1.3145,105,1.5088,0.5455,4102169,4102190
0.4739,0.4275,1.6367,70,30,45,25,2.7432,1.2418,100,1.5014,0.5452,4102190,4102210
0.4861,0.3038,1.755,70,60,45,25,2.8082,1.5174,130,1.2908,0.5643,4109047,4109073
0.4784,0.3549,1.8861,75,55,40,35,3.0013,1.365,130,1.6363,0.5396,4109073,4109099
0.477,0.3404,1.69,80,55,60,20,2.8614,1.3,135,1.5614,0.5414,4109184,4109211
0.5116,0.3456,1.6912,75,45,55,20,2.798,1.4359,120,1.3621,0.5723,4124024,4124048
0.4993,0.3659,1.625,80,50,50,30,2.9971,1.4315,130,1.5656,0.5708,4124048,4124074
0.4858,0.3542,1.365,75,20,45,30,2.5564,1.4964,95,1.06,0.5766,4124074,4124093
0.5,0.4054,1.69,80,50,50,30,2.86,1.2418,130,1.6182,0.5675,4124093,4124119
0.5204,0.4093,1.7012,75,30,40,35,2.8753,1.43,105,1.4453,0.544,4124119,4124140
0.4877,0.3819,1.56,100,10,50,50,3.0686,1.4964,110,1.5721,0.5602,4124140,4124162
0.4545,0.4798,1.6263,70,25,45,25,3.0168,1.4964,95,1.5204,0.5539,4124162,4124181
0.4834,0.3609,1.7562,85,30,40,45,2.9614,1.3712,115,1.5902,0.5633,4124181,4124204
0.5435,0.3253,1.8212,80,35,50,30,2.99,1.5654,115,1.4246,0.5778,4132080,4132103
0.522,0.3487,1.9597,70,30,45,25,2.9914,1.625,100,1.3664,0.5821,4132103,4132123
0.4763,0.4002,1.69,75,25,45,30,2.8656,1.5614,100,1.3043,0.5799,4132123,4132143
0.5418,0.3965,1.69,75,45,50,25,3.009,1.365,120,1.644,0.5667,4132143,4132167
0.541,0.3923,1.8861,70,35,45,25,3.1444,1.6302,105,1.5143,0.5452,4132167,4132188
0.553,0.3408,1.7562,70,35,50,20,2.7666,1.6367,105,1.13,0.5245,4155196,4155217
0.5393,0.3775,1.9769,70,45,45,25,3.1547,1.3712,115,1.7835,0.5526,4162031,4162054
0.5191,0.3823,2.0192,70,40,40,30,3.2554,1.7012,110,1.5542,0.5383,4162054,4162076
0.488,0.3219,2.0317,85,25,50,35,3.1967,1.69,110,1.5067,0.5371,4162076,4162098
0.5208,0.302,1.8304,105,20,65,40,3.1227,1.56,125,1.5627,0.5243,4162098,4162123
0.5,0.3759,1.8212,70,20,45,25,2.99,1.6263,90,1.3637,0.5425,4162123,4162141
0.5216,0.4086,1.7012,80,20,40,40,3.0013,1.495,100,1.5063,0.5473,4162141,4162161
0.475,0.4248,1.5614,65,10,40,25,2.6,1.5654,75,1.0346,0.5505,4162161,4162176
0.5118,0.4354,1.7099,65,35,55,10,2.9321,1.4315,100,1.5006,0.5547,4170107,4170127
0.5392,0.3164,1.6263,80,45,55,25,2.543,1.5006,125,1.0423,0.5543,4170127,4170152
0.5106,0.3829,1.8861,70,40,50,20,3.055,1.4432,110,1.6118,0.5583,4200027,4200049
0.5022,0.3308,1.9543,60,30,50,10,2.7454,1.56,90,1.1854,0.5756,4200049,4200067
0.4897,0.3712,1.8212,60,45,50,10,2.9323,1.3789,105,1.5535,0.5743,4200067,4200088
0.521,0.3848,1.8385,80,25,55,25,3.1213,1.4359,105,1.6854,0.5775,4200088,4200109
0.4751,0.3511,1.9597,75,20,50,25,3.013,1.6263,95,1.3867,0.5924,4200109,4200128
0.4752,0.4739,1.6302,75,10,50,25,2.7359,1.4315,85,1.3044,0.6044,4200128,4200145
0.5109,0.433,1.495,90,30,50,40,2.9265,1.3,120,1.6265,0.609,4200145,4200169
0.4861,0.4072,1.5654,65,30,55,10,2.8082,1.5174,95,1.2908,0.5095,4215036,4215055
0.4535,0.4288,1.6302,65,35,55,10,2.7382,1.365,100,1.3732,0.5214,4215055,4215075
0.4528,0.3034,1.5721,90,50,55,35,2.7425,1.2418,140,1.5006,0.535,4215075,4215103
0.4797,0.3641,1.4964,75,45,50,25,2.4985,1.2418,120,1.2567,0.5465,4215103,4215127
0.4317,0.3839,1.5654,70,65,55,15,2.7475,1.1985,135,1.549,0.5442,4215127,4215154
0.4867,0.3789,1.695,80,50,55,25,2.6712,1.1861,130,1.485,0.5253,4215154,4215180
0.4575,0.4019,1.2418,100,10,80,20,2.5613,1.3,110,1.2613,0.5422,4215180,4215202
0.477,0.3276,1.625,80,80,45,35,2.8614,1.17,160,1.6914,0.5491,5018138,5018170
0.4845,0.2474,1.5654,70,50,45,25,2.4482,1.365,120,1.0832,0.5456,5018170,5018194
0.5244,0.37,1.43,80,45,70,10,2.6292,1.1861,125,1.443,0.5398,5018194,5018219
0.4846,0.4635,1.5006,65,30,50,15,2.82,1.4315,95,1.3885,0.5401,5025144,5025163
0.4254,0.3651,1.3016,85,40,50,35,2.6019,1.1221,125,1.4798,0.5813,5033044,5033069
0.4527,0.365,1.4432,95,45,45,50,2.7317,1.1069,140,1.6248,0.5813,5033069,5033097
0.4752,0.4738,1.4315,70,45,45,25,2.613,1.2367,115,1.3763,0.5836,5033097,5033120
0.4866,0.4462,1.1718,90,10,55,35,2.419,1.2418,100,1.1772,0.5777,5033120,5033140
0.4969,0.4417,1.3016,80,45,55,25,2.4853,1.1772,125,1.3081,0.5587,5033140,5033165
0.5077,0.3761,1.4315,80,70,55,25,2.5637,1.235,150,1.3287,0.5349,5033165,5033195
0.4905,0.3676,1.4964,75,40,50,25,2.8328,1.4359,115,1.3969,0.5664,5040173,5040196
0.4645,0.3192,1.6263,90,50,60,30,2.6733,1.3016,140,1.3717,0.5736,5078039,5078067
0.508,0.3911,1.9543,60,35,45,15,2.9541,1.5815,95,1.3726,0.5264,5086168,5086187
0.4792,0.4593,1.4315,65,30,45,20,2.7261,1.5006,95,1.2255,0.5353,5086187,5086206
0.4997,0.4667,1.5006,65,60,45,20,2.7315,1.1718,125,1.5597,0.527,5093068,5093093
0.456,0.4844,1.3065,85,25,55,30,2.9967,1.365,110,1.6317,0.5313,5093093,5093115
0.4571,0.4173,1.5721,75,40,55,20,2.8759,1.3665,115,1.5094,0.498,5093115,5093138
0.5355,0.3597,1.56,65,65,55,10,2.6733,1.3145,130,1.3588,0.4966,5093138,5093164
0.4413,0.4068,1.5614,65,50,50,15,2.8021,1.4315,115,1.3706,0.5129,5093164,5093187
0.4912,0.3865,1.5077,75,65,45,30,2.9382,1.2367,140,1.7015,0.5185,5093187,5093215
0.5091,0.3946,1.5614,70,50,45,25,2.8089,1.3665,120,1.4423,0.5272,5101088,5101112
0.5401,0.3953,1.3665,70,20,50,20,2.4069,1.43,90,0.9769,0.5291,5101112,5101130
0.5003,0.3102,1.5654,85,35,60,25,2.6016,1.3,120,1.3016,0.5125,5101130,5101154
0.4678,0.3855,1.5614,80,35,50,30,2.9312,1.43,115,1.5012,0.5376,5108084,5108107
0.4645,0.3978,1.4315,80,35,60,20,2.8023,1.3712,115,1.4311,0.52,5108107,5108130
0.4606,0.3247,1.6302,75,40,55,20,2.5561,1.3016,115,1.2544,0.5108,5108130,5108153
0.5534,0.3854,1.3,75,40,60,15,2.4915,1.1772,115,1.3143,0.5158,5108153,5108176
0.4465,0.4583,2.145,70,80,35,35,3.6423,1.235,150,2.4073,0.5367,5131141,5131171
0.4884,0.5657,1.5603,75,135,40,35,2.798,1.6263,60,1.1717,0.5167,5131171,5131183
0.5147,0.3073,1.4964,60,10,45,15,2.1802,1.3665,70,0.8137,0.542,5131183,5131197
0.5128,0.4711,1.235,80,30,55,25,2.5383,1.1221,110,1.4163,0.5644,5131197,5131219
0.4443,0.338,1.2418,95,15,55,40,2.5252,1.3,110,1.2252,0.5534,5138040,5138062
0.4367,0.4223,1.235,80,45,50,30,2.7161,1.1221,125,1.594,0.5306,5138062,5138087
0.4876,0.3728,1.365,75,70,50,25,2.8024,1.1861,145,1.6163,0.53,5138087,5138116
0.4394,0.3696,1.5614,65,35,40,25,2.5536,1.3665,100,1.187,0.5322,5138116,5138136
0.4979,0.4833,1.365,65,30,40,25,2.2347,1.1221,95,1.1126,0.5481,5138136,5138155
0.5372,0.4411,1.365,65,45,45,20,2.5437,1.1126,110,1.4311,0.5414,5138155,5138177
0.4759,0.3759,1.6302,75,25,50,25,2.7315,1.5935,100,1.138,0.505,5146098,5146118
0.499,0.2831,1.6912,80,55,50,30,2.4785,1.2367,135,1.2418,0.4771,5168099,5168126
0.4648,0.3488,1.5614,70,65,50,20,2.6718,1.2367,135,1.4351,0.4926,5168126,5168153
0.5226,0.4471,1.82,60,30,40,20,3.008,1.69,90,1.318,0.5245,5183150,5183168
0.4838,0.4372,1.495,60,30,45,15,2.4221,1.3065,90,1.1156,0.5324,5191042,5191060
0.545,0.4437,1.3016,75,25,55,20,2.4327,1.1718,100,1.2609,0.5318,5191060,5191080
0.4908,0.4849,1.5006,65,45,40,25,2.9611,1.3257,110,1.6354,0.5334,5191080,5191102
0.4886,0.441,1.5006,75,20,55,20,2.5418,1.3257,95,1.2161,0.5523,5191185,5191204
0.5358,0.3985,1.4315,70,50,50,20,2.6935,1.2367,120,1.4568,0.5366,5198032,5198056
0.4563,0.3428,1.4315,75,35,55,20,2.4384,1.4432,110,0.9951,0.5471,5198056,5198078
0.5239,0.4505,1.4315,70,30,50,20,2.6084,1.1772,100,1.4312,0.5307,5198172,5198192
0.5124,0.383,1.5614,65,40,50,15,2.8024,1.3665,105,1.4359,0.5236,5198192,5198213
0.4822,0.3925,1.3016,85,40,55,30,2.7096,1.3257,125,1.3839,0.5523,5206109,5206134
0.5031,0.3196,1.885,70,55,45,25,2.4853,1.3712,125,1.1141,0.505,5221044,5221069
0.4767,0.2752,1.8212,75,70,50,25,2.7578,1.2503,145,1.5075,0.5143,5221069,5221098
0.4537,0.3291,1.6912,75,80,40,35,2.8654,1.3145,155,1.5509,0.5207,5221098,5221129
0.4648,0.3185,1.4432,85,45,60,25,2.6718,1.3,130,1.3718,0.5172,5221129,5221155
0.491,0.3549,1.755,75,75,55,20,2.9396,1.2418,150,1.6978,0.4859,5221155,5221185
0.5113,0.2721,1.9511,100,55,55,45,2.9264,1.4432,155,1.4832,0.4813,5221185,5221216
0.4821,0.383,1.6302,75,45,50,25,2.8315,1.3145,120,1.5169,0.5541,5236182,5236206
0.495,0.3407,1.1718,105,30,70,35,2.8346,1.3145,135,1.5201,0.518,5244045,5244072
0.4616,0.3412,1.3,80,50,60,20,2.5384,1.4032,130,1.1352,0.507,5244072,5244098
0.5122,0.4225,1.4964,70,35,55,15,2.665,1.4315,105,1.2335,0.5305,5251146,5251167
0.4808,0.3555,1.7099,70,40,45,25,2.7572,1.43,110,1.3272,0.5991,6003083,6003105
0.5113,0.3711,1.8861,60,70,35,25,2.9264,1.3257,130,1.6007,0.5867,6003105,6003131
0.4895,0.387,1.8304,80,35,45,35,3.0798,1.4964,115,1.5834,0.5894,6003131,6003154
0.4869,0.3345,1.7598,70,45,45,25,3.0822,1.495,115,1.5872,0.5704,6011126,6011149
0.4717,0.3218,1.8488,65,50,45,20,2.8407,1.5006,115,1.34,0.5582,6011149,6011172
0.4878,0.307,1.8212,65,80,45,20,2.665,1.365,145,1.3,0.6143,6018035,6018064
0.4885,0.4236,1.5077,75,40,55,20,2.8071,1.3,115,1.5071,0.622,6018064,6018087
0.489,0.3288,1.4964,105,20,65,40,2.9365,1.5654,125,1.3711,0.58,6026030,6026055
0.4873,0.3071,1.6263,85,45,50,35,2.8009,1.4359,130,1.365,0.5703,6026055,6026081
0.4967,0.3497,1.5654,80,55,60,20,2.7607,1.365,135,1.3957,0.5646,6026081,6026108
0.492,0.4481,1.8212,65,55,50,15,2.9541,1.3712,120,1.5829,0.5675,6026108,6026132
0.5,0.3125,1.56,70,70,45,25,2.6032,1.4534,140,1.1498,0.5614,6026132,6026160
0.5132,0.3333,1.5654,75,55,50,25,2.8323,1.3016,130,1.5307,0.57,6026160,6026186
0.511,0.4101,1.7562,70,40,45,25,2.9365,1.4534,110,1.4831,0.5608,6026186,6026208
0.4632,0.3661,1.7099,95,15,50,45,3.0872,1.4359,110,1.6513,0.5893,6034048,6034070
0.471,0.4341,1.6457,85,25,50,35,3.0395,1.43,110,1.6095,0.5998,6034070,6034092
0.5193,0.4266,1.7562,70,50,40,30,2.8237,1.2418,120,1.5819,0.6129,6041035,6041059
0.5,0.2723,1.9511,105,35,75,30,2.7331,1.4665,140,1.2666,0.586,6041059,6041087
0.4527,0.1151,1.7598,75,230,55,20,2.7317,1.3665,305,1.3652,0.6012,6041087,6041148
0.4716,0.2978,1.6912,70,65,50,20,2.9239,1.2367,135,1.6872,0.5836,6041148,6041175
0.4872,0.39,1.7742,60,50,40,20,2.8144,1.3789,110,1.4356,0.5481,6041175,6041197
0.5094,0.3123,1.755,95,55,50,45,3.0731,1.3665,150,1.7065,0.5803,6071163,6071193
0.5218,0.3384,1.5614,95,30,55,40,2.8676,1.5654,125,1.3022,0.5891,6071193,6071218
0.5718,0.3607,1.69,75,25,35,40,2.7493,1.43,100,1.3193,0.5837,6079051,6079071
0.4694,0.4229,1.5654,90,15,55,35,3.1877,1.5721,105,1.6155,0.5866,6079071,6079092
0.4763,0.3933,1.8304,75,25,45,30,3.0021,1.4964,100,1.5057,0.5658,6079092,6079112
0.4675,0.4721,1.4359,80,15,50,30,3.0617,1.43,95,1.6317,0.5931,6079112,6079131
0.5049,0.4521,1.56,75,15,50,25,2.9357,1.4315,90,1.5042,0.6087,6079131,6079149
0.4751,0.475,1.56,70,30,40,30,3.013,1.4822,100,1.5308,0.6107,6079149,6079169
0.5203,0.4603,1.5654,75,15,50,25,2.7935,1.4315,90,1.362,0.6062,6079169,6079187
0.5077,0.364,1.8613,60,45,50,10,2.5637,1.3712,105,1.1925,0.5596,6094025,6094046
0.4979,0.3847,1.625,75,35,45,30,2.6403,1.3665,110,1.2737,0.5912,6094160,6094182
0.449,0.3671,1.5006,95,25,50,45,2.7541,1.3145,120,1.4396,0.603,6094182,6094206
0.4954,0.3473,1.6912,65,45,50,15,2.6274,1.4359,110,1.1915,0.5969,6101058,6101080
0.4764,0.3232,1.8304,70,60,55,15,2.7424,1.3016,130,1.4408,0.5829,6101080,6101106
0.4742,0.3178,1.5654,80,40,50,30,2.6079,1.3065,120,1.3014,0.5834,6101106,6101130
0.5011,0.2993,1.5077,85,50,55,30,2.349,1.2367,135,1.1123,0.5741,6101130,6101157
0.4507,0.3636,1.9028,75,70,40,35,3.0423,1.1772,145,1.8651,0.5818,6101157,6101186
0.493,0.3696,1.365,95,15,60,35,2.8464,1.3712,110,1.4752,0.5758,6101186,6101208
0.4888,0.3547,1.8304,65,65,45,20,2.843,1.5721,130,1.2708,0.5598,6109036,6109062
0.4683,0.3657,1.6457,80,35,60,20,2.9443,1.3895,115,1.5547,0.5528,6109062,6109085
0.531,0.3882,1.5654,80,35,55,25,2.9402,1.3789,115,1.5614,0.5675,6109085,6109108
0.5342,0.4132,1.69,65,40,45,20,2.9304,1.5614,105,1.3691,0.5776,6109108,6109129
0.5019,0.4441,1.8212,70,30,50,20,3.175,1.5654,100,1.6096,0.5606,6109129,6109149
0.4851,0.4524,1.8861,60,30,40,20,3.2185,1.5935,90,1.625,0.5506,6109149,6109167
0.4979,0.4538,1.8246,60,30,45,15,3.0027,1.5614,90,1.4413,0.5534,6109167,6109185
0.4959,0.4474,1.7562,60,30,35,25,2.8834,1.495,90,1.3884,0.5499,6109185,6109203
0.5293,0.3598,1.6263,85,65,55,30,2.7129,1.2367,150,1.4762,0.5762,6116037,6116067
0.4856,0.3532,1.6912,75,40,50,25,2.6805,1.4359,115,1.2446,0.5673,6116067,6116090
0.4481,0.3237,1.4315,95,25,60,35,2.615,1.3016,120,1.3134,0.564,6116090,6116114
0.4151,0.3625,1.7099,80,65,55,25,2.8573,1.1718,145,1.6855,0.5765,6116114,6116143
0.4052,0.4267,1.5006,70,35,45,25,2.5719,1.1861,105,1.3858,0.5746,6116143,6116164
0.4349,0.4502,1.3665,75,40,50,25,2.7071,1.042,115,1.6651,0.5848,6116164,6116187
0.5433,0.3959,1.3016,80,25,50,30,2.4195,1.1772,105,1.2423,0.5588,6116187,6116208
0.4948,0.4308,1.9769,65,40,40,25,3.3078,1.56,105,1.7478,0.5577,6124098,6124119
0.466,0.4776,1.9769,55,15,40,15,3.0816,1.6367,70,1.4449,0.5842,6124119,6124133
0.4648,0.3405,1.6302,85,20,55,30,2.6718,1.4359,105,1.2359,0.571,6124133,6124154
0.4747,0.443,1.4359,70,20,50,20,2.6015,1.3257,90,1.2758,0.5645,6131178,6131196
0.5,0.3801,1.5614,80,20,55,25,2.7331,1.4534,100,1.2796,0.5347,6139062,6139082
0.5,0.3822,1.3016,85,30,50,35,2.6291,1.3665,115,1.2625,0.5638,6139082,6139105
0.489,0.3839,1.695,85,45,50,35,2.9365,1.3145,130,1.622,0.5443,6139105,6139131
0.4755,0.347,1.721,70,30,55,15,2.7375,1.4359,100,1.3016,0.5462,6139131,6139151
0.4918,0.3948,1.9543,75,60,50,25,3.3279,1.3016,135,2.0263,0.5314,6139151,6139178
0.4928,0.3857,1.7012,65,20,45,20,2.8195,1.6367,85,1.1829,0.5371,6139178,6139195
0.4869,0.3956,1.695,60,45,50,10,2.5366,1.3665,105,1.1701,0.5514,6146139,6146160
0.4549,0.3836,1.82,55,50,40,15,2.8719,1.235,105,1.6369,0.5352,6146160,6146181
0.5342,0.4843,1.6263,55,40,40,15,2.8222,1.3065,95,1.5157,0.5259,6146181,6146200
0.623,0.4097,1.625,45,20,45,0,2.42,1.5077,65,0.9123,0.5718,6146200,6146213
0.5368,0.3923,1.495,80,25,55,25,2.6665,1.43,105,1.2365,0.5537,6161039,6161060
0.4422,0.3698,1.6302,65,50,50,15,2.7967,1.3016,115,1.4951,0.5613,6161148,6161171
0.4977,0.4028,1.43,90,30,60,30,2.8732,1.2367,120,1.6365,0.5669,6161171,6161195
0.4767,0.3573,2.0244,60,30,45,15,2.7578,1.6302,90,1.1276,0.5407,6169063,6169081
0.4645,0.3387,1.6572,70,30,55,15,2.6733,1.3145,100,1.3588,0.5497,6169081,6169101
0.469,0.41,1.7598,60,40,45,15,2.9402,1.3895,100,1.5507,0.5568,6169179,6169199
0.4901,0.4406,1.7562,75,25,50,25,3.062,1.3789,100,1.6831,0.5529,6169199,6169219
0.4347,0.3654,1.695,70,55,70,0,2.8447,1.3016,125,1.5431,0.5164,6176073,6176098
0.4599,0.2684,1.2367,110,0,80,30,2.4191,1.2367,110,1.1824,0.508,6176098,6176120
0.5124,0.3975,1.4964,85,30,55,30,2.8024,1.2621,115,1.5404,0.5451,6191124,6191147
0.5114,0.4102,1.5006,80,25,55,25,2.8221,1.4359,105,1.3862,0.5711,6191147,6191168
0.4861,0.3461,1.56,75,15,55,20,2.4067,1.4432,90,0.9635,0.5519,6191168,6191186
0.5134,0.3438,1.3712,100,10,60,40,2.419,1.17,110,1.249,0.5632,6191186,6191208
0.521,0.3336,1.7598,75,55,45,30,3.1213,1.3665,130,1.7548,0.6029,6199071,6199097
0.5514,0.4383,1.8895,65,30,45,20,3.1913,1.6263,95,1.565,0.6179,6199097,6199116
0.5049,0.3832,2.081,65,20,45,20,3.2185,1.7598,85,1.4587,0.6089,6199116,6199133
0.4586,0.371,1.4432,85,30,60,25,2.5667,1.3016,115,1.2651,0.6756,6229092,6229115
0.4752,0.3599,1.6912,90,45,55,35,2.613,1.1772,135,1.4358,0.6843,6229115,6229142
0.5103,0.3566,1.5721,90,55,50,40,2.9323,1.2418,145,1.6905,0.6902,6229142,6229171
0.5013,0.3234,1.7562,85,35,55,30,2.8791,1.4964,120,1.3827,0.6928,6229171,6229195
0.592,0.3786,1.7742,65,45,50,15,2.8229,1.365,110,1.4579,0.6901,6237124,6237146
0.4566,0.3185,1.6572,85,40,55,30,2.9928,1.6711,125,1.3217,0.6679,6237146,6237171
0.5258,0.3185,1.6912,85,50,55,30,2.6079,1.3665,135,1.2413,0.683,6237171,6237198
0.4739,0.2643,1.5721,85,40,55,30,2.3476,1.3145,125,1.0331,0.6612,6244026,6244051
0.4812,0.2803,1.7012,75,85,50,25,2.3936,1.1126,160,1.281,0.6488,6244051,6244083
0.5,0.2796,1.4665,80,80,65,15,2.5541,1.1518,160,1.4023,0.6464,6244083,6244115
0.5,0.278,1.8385,70,90,45,25,2.6291,1.277,160,1.352,0.6632,6244115,6244147
0.4369,0.3777,1.6912,65,50,40,25,2.9227,1.3145,115,1.6082,0.6727,6244147,6244170
0.4854,0.4752,1.7012,65,35,40,25,2.8246,1.277,100,1.5476,0.6474,6244170,6244190
0.4778,0.4792,1.4534,70,10,55,15,2.5991,1.3712,80,1.2279,0.6482,6244190,6244206
0.5756,0.285,2.6777,70,65,45,25,3.7265,2.015,135,1.7115,0.6221,7011037,7011064
0.5494,0.3111,2.419,80,30,45,35,3.9058,2.145,110,1.7608,0.6109,7011064,7011086
0.5483,0.2815,2.3544,75,25,45,30,3.4564,2.146,100,1.3104,0.6229,7011086,7011106
0.5596,0.272,2.2186,85,20,55,30,3.2605,1.8951,105,1.3655,0.6249,7011106,7011127
0.5732,0.2478,2.2981,95,55,50,45,3.5156,1.8246,150,1.691,0.6062,7011127,7011157
0.5809,0.2547,2.5425,70,55,45,25,3.5806,2.015,125,1.5656,0.5969,7011157,7011182
0.581,0.2501,2.2787,80,40,50,30,3.2616,2.08,120,1.1816,0.5971,7011182,7011206
0.5502,0.3073,2.081,90,20,50,40,3.3268,1.9128,110,1.414,0.6091,7018114,7018136
0.5297,0.2844,1.9597,85,30,55,30,3.1906,1.8304,115,1.3602,0.6152,7018136,7018159
0.5199,0.2769,2.1489,70,55,50,20,3.2604,1.69,125,1.5704,0.6153,7018159,7018184
0.5094,0.3245,2.1538,75,50,50,25,3.4475,1.695,125,1.7525,0.5935,7018184,7018209
0.5464,0.3432,2.0244,80,25,55,25,3.1295,1.7012,105,1.4283,0.6339,7026099,7026120
0.5514,0.3244,1.9597,80,25,55,25,3.2174,1.7099,105,1.5075,0.6246,7026120,7026141
0.5327,0.3295,2.0891,85,15,50,35,3.0726,1.6302,100,1.4424,0.5946,7034038,7034058
0.546,0.39,1.9673,75,45,40,35,3.5793,1.6367,120,1.9427,0.5785,7034058,7034082
0.4902,0.3831,2.0244,75,10,40,35,3.3175,1.9543,85,1.3632,0.5939,7034082,7034099
0.5163,0.3636,1.8385,75,25,40,35,3.0319,1.6263,100,1.4056,0.5949,7034099,7034119
0.5136,0.2908,1.6302,90,20,55,35,2.8098,1.5654,110,1.2444,0.6028,7034119,7034141
0.509,0.2526,1.5614,115,65,55,60,2.9396,1.4432,180,1.4964,0.6145,7034141,7034177
0.5003,0.3112,1.69,75,60,50,25,2.8615,1.4964,135,1.3651,0.6127,7034177,7034204
0.5313,0.3039,2.1538,80,60,40,40,3.3396,1.6367,140,1.7029,0.5992,7049035,7049063
0.5607,0.3855,1.8212,70,40,55,15,3.1387,1.7742,110,1.3645,0.5887,7049063,7049085
0.5091,0.3352,1.82,80,35,40,40,3.2023,1.7598,115,1.4425,0.6,7049085,7049108
0.5309,0.3085,1.6263,85,35,55,30,2.8264,1.6302,120,1.1962,0.6199,7049108,7049132
0.5436,0.3094,1.69,95,40,65,30,2.88,1.5006,135,1.3793,0.62,7049132,7049159
0.5149,0.3545,1.6263,90,35,45,45,3.2847,1.5654,125,1.7193,0.6099,7049159,7049184
0.5328,0.3988,1.6912,90,15,55,35,3.0889,1.56,105,1.5289,0.581,7064185,7064206
0.5538,0.3055,1.9597,120,20,75,45,3.5232,1.7562,140,1.767,0.6066,7071031,7071059
0.5406,0.3557,1.8861,80,5,50,30,3.2818,1.9511,85,1.3307,0.5999,7071059,7071076
0.5408,0.3516,1.7562,90,15,50,40,3.1271,1.7742,105,1.353,0.584,7071076,7071097
0.5285,0.3809,1.8951,80,35,50,30,3.3204,1.6912,115,1.6292,0.5866,7071097,7071120
0.5327,0.3399,1.6302,90,30,60,30,2.951,1.5654,120,1.3856,0.5787,7071183,7071207
0.4943,0.405,1.9511,75,35,45,30,3.4294,1.6302,110,1.7992,0.5888,7094044,7094066
0.497,0.3771,2.0841,70,30,40,30,3.272,1.695,100,1.577,0.5441,7094066,7094086
0.5459,0.3739,2.0244,60,25,45,15,2.9192,1.6263,85,1.2929,0.5566,7094086,7094103
0.5537,0.3588,1.8951,80,25,55,25,3.0724,1.5935,105,1.4789,0.5351,7094103,7094124
0.5509,0.3892,2.0891,65,30,40,25,3.1877,1.7012,95,1.4865,0.5429,7094124,7094143
0.5562,0.3469,1.9597,70,15,50,20,2.8436,1.7562,85,1.0874,0.5565,7094143,7094160
0.5333,0.3664,1.8212,85,30,55,30,3.2063,1.5815,115,1.6248,0.553,7094160,7094183
0.4972,0.2587,1.9511,85,40,60,25,3.0181,1.7099,125,1.3082,0.5575,7094183,7094208
0.5218,0.3495,1.7658,65,35,45,20,2.8676,1.6912,100,1.1763,0.6143,7101034,7101054
0.5211,0.331,1.695,70,45,45,25,2.8795,1.4964,115,1.3831,0.6021,7101054,7101077
0.5256,0.3415,1.8212,90,40,50,40,3.0915,1.5006,130,1.5908,0.6029,7101077,7101103
0.5335,0.3097,1.8304,100,40,45,55,3.2049,1.625,140,1.5799,0.5951,7101103,7101131
0.5734,0.3216,1.8895,85,15,50,35,3.0627,1.7099,100,1.3528,0.5954,7101131,7101151
0.5652,0.3109,1.8951,85,20,50,35,2.99,1.7562,105,1.2338,0.5625,7101151,7101172
0.522,0.3603,1.7562,75,25,50,25,2.9914,1.69,100,1.3014,0.5762,7101172,7101192
0.5317,0.4132,1.625,85,20,55,30,3.0661,1.5614,105,1.5047,0.5758,7101192,7101213
0.4761,0.3796,2.081,70,45,45,25,3.5526,1.5815,115,1.971,0.5319,7109145,7109168
0.4932,0.3734,1.9511,70,20,45,25,3.1021,1.6912,90,1.4108,0.5468,7109168,7109186
0.4843,0.3082,1.8861,80,40,55,25,3.0899,1.6263,120,1.4636,0.5421,7124040,7124064
0.489,0.2637,1.7562,90,55,55,35,2.9365,1.4964,145,1.4401,0.5441,7124064,7124093
0.5521,0.312,1.755,95,45,55,40,3.0612,1.4359,140,1.6253,0.5439,7124093,7124121
0.5,0.4066,2.0962,70,30,50,20,3.39,1.69,100,1.7,0.5311,7124121,7124141
0.5285,0.3839,1.8895,80,20,55,25,3.1977,1.695,100,1.5027,0.5366,7124141,7124161
0.49,0.4234,2.08,55,45,40,15,3.3162,1.69,100,1.6262,0.5244,7124161,7124181
0.5297,0.3421,1.9543,75,35,45,30,3.1906,1.625,110,1.5656,0.5312,7124181,7124203
0.5199,0.4359,2.016,55,25,40,15,3.1256,1.69,80,1.4356,0.5447,7124203,7124219
0.478,0.4238,1.8212,75,40,45,30,3.1746,1.5006,115,1.674,0.5484,7131044,7131067
0.5392,0.3606,1.7562,100,30,55,45,3.2568,1.5174,130,1.7394,0.5347,7131067,7131093
0.459,0.3112,2.211,65,60,45,20,3.1444,1.7562,125,1.3882,0.5305,7131093,7131118
0.5085,0.3219,2.2252,65,70,45,20,3.1984,1.4432,135,1.7552,0.5219,7131118,7131145
0.5016,0.4244,1.9543,70,45,45,25,3.263,1.6263,115,1.6367,0.5223,7131145,7131168
0.4783,0.3796,1.8861,70,25,45,25,2.9928,1.6367,95,1.3562,0.5267,7131168,7131187
0.502,0.4062,1.8951,70,45,45,25,2.8747,1.4315,115,1.4432,0.5333,7131187,7131210
0.5544,0.3179,1.6912,80,15,60,20,2.7869,1.7099,95,1.077,0.5415,7139042,7139061
0.5668,0.3524,1.8246,75,45,55,20,3.0012,1.545,120,1.4562,0.5485,7139061,7139085
0.4901,0.338,1.95,70,35,45,25,3.2272,1.7012,105,1.526,0.5376,7139085,7139106
0.5217,0.3169,2.0317,75,30,50,25,2.9928,1.5815,105,1.4113,0.5295,7139106,7139127
0.5028,0.361,2.0244,65,50,45,20,3.2343,1.5614,115,1.673,0.5168,7139127,7139150
0.5631,0.3277,2.0317,70,30,55,15,2.6946,1.6263,100,1.0683,0.5138,7139150,7139170
0.5128,0.2484,1.6912,70,50,50,20,2.5383,1.5174,120,1.0209,0.5371,7139170,7139194
0.5571,0.3622,2.2138,75,65,35,40,3.7412,1.6302,140,2.111,0.5591,7146041,7146069
0.5245,0.4501,2.0841,70,0,45,25,3.596,2.0841,70,1.5119,0.5446,7146069,7146083
0.5327,0.386,1.9597,70,5,50,20,3.0602,1.8861,75,1.1741,0.5329,7146083,7146098
0.5111,0.3809,1.755,70,25,45,25,2.9279,1.6302,95,1.2977,0.5649,7146098,7146117
0.5585,0.3898,1.8212,55,30,30,25,2.6868,1.5077,85,1.1791,0.5558,7162034,7162051
0.4763,0.3278,1.7598,80,30,50,30,2.8656,1.5006,110,1.365,0.5362,7162051,7162073
0.4881,0.3578,1.695,70,35,55,15,2.6666,1.365,105,1.3016,0.5179,7162073,7162094
0.4771,0.4072,1.82,75,50,50,25,3.0248,1.3016,125,1.7231,0.522,7162094,7162119
0.5208,0.3777,1.6572,100,15,60,40,3.1227,1.4432,115,1.6795,0.5272,7162119,7162142
0.4815,0.4036,1.6263,75,15,55,20,3.0189,1.6263,90,1.3926,0.5284,7162142,7162160
0.5124,0.3427,1.8212,65,40,45,20,2.8024,1.5614,105,1.2411,0.557,7169035,7169056
0.523,0.3992,1.82,60,55,45,15,3.0469,1.4359,115,1.611,0.5418,7169056,7169079
0.5158,0.3938,1.6912,70,25,50,20,2.8982,1.5935,95,1.3047,0.5277,7169079,7169098
0.4922,0.3958,1.9511,65,40,45,20,3.0828,1.495,105,1.5878,0.5424,7169098,7169119
0.5117,0.3942,1.6263,80,25,60,20,2.9465,1.5174,105,1.4291,0.5566,7169119,7169140
0.5112,0.3342,1.5006,85,30,60,25,2.673,1.5077,115,1.1654,0.5549,7169140,7169163
0.5179,0.3835,1.8895,70,55,60,10,3.1476,1.3665,125,1.7811,0.5405,7169163,7169188
0.4896,0.4027,1.9597,65,30,45,20,3.0564,1.6302,95,1.4262,0.5324,7169188,7169207
0.5132,0.3249,1.7099,80,45,40,40,2.8323,1.3665,125,1.4658,0.601,7177037,7177062
0.4829,0.3844,1.8212,60,40,50,10,2.8107,1.4534,100,1.3572,0.6057,7177062,7177082
0.4883,0.3268,1.6263,70,45,55,15,2.8206,1.3572,115,1.4633,0.6075,7177082,7177105
0.4981,0.396,1.8895,65,55,40,25,3.175,1.3773,120,1.7977,0.5904,7177105,7177129
0.4824,0.3071,1.7562,75,35,50,25,2.833,1.5815,110,1.2515,0.5653,7177129,7177151
0.4882,0.3397,1.7012,65,75,45,20,2.9321,1.3665,140,1.5656,0.57,7177151,7177179
0.5536,0.3716,1.6302,80,35,50,30,2.6252,1.4315,115,1.1938,0.5829,7177179,7177202
0.4642,0.3535,1.6367,90,35,50,40,3.0931,1.4315,125,1.6616,0.593,7184036,7184061
0.5342,0.3214,1.5006,100,25,55,45,2.8222,1.4359,125,1.3863,0.5982,7184061,7184086
0.5455,0.3226,1.885,75,45,50,25,2.7509,1.5077,120,1.2433,0.5739,7184086,7184110
0.5528,0.2243,2.016,95,90,70,25,2.9395,1.5006,185,1.4389,0.5548,7184110,7184147
0.485,0.3487,1.7099,120,50,90,30,3.417,1.2418,170,2.1752,0.5589,7192029,7192063
0.5334,0.4221,2.041,65,25,45,20,3.0681,1.6572,90,1.411,0.5573,7192063,7192081
0.5128,0.391,1.755,75,15,45,30,2.9834,1.6367,90,1.3467,0.5457,7192081,7192099
0.4882,0.3745,1.8304,85,40,50,35,3.198,1.5299,125,1.6681,0.5568,7192099,7192124
0.5,0.333,1.7742,80,15,60,20,2.863,1.5614,95,1.3016,0.5563,7192124,7192143
0.5154,0.3708,1.8861,70,55,50,20,3.3179,1.4315,125,1.8864,0.5595,7192143,7192168
0.4708,0.4156,1.9673,70,25,45,25,3.3252,1.7099,95,1.6153,0.5423,7192168,7192187
0.5299,0.3289,1.7742,85,30,55,30,2.9847,1.5654,115,1.4193,0.5468,7192187,7192210
0.4763,0.3981,1.7658,75,10,55,20,2.8656,1.6302,85,1.2354,0.5782,7199090,7199107
0.43,0.3699,1.6457,85,30,60,25,2.9075,1.365,115,1.5425,0.5712,7199107,7199130
0.5018,0.3377,1.7848,80,50,50,30,2.8967,1.2503,130,1.6464,0.59,7199130,7199156
0.4984,0.4347,1.7099,65,30,40,25,3.0251,1.4534,95,1.5717,0.59,7199156,7199175
0.5012,0.3715,1.6572,80,25,55,25,3.0083,1.5077,105,1.5006,0.5845,7199175,7199196
0.515,0.3908,1.8951,70,40,45,25,2.9273,1.4432,110,1.4841,0.6213,7207022,7207044
0.5197,0.3795,1.8385,70,35,45,25,3.0046,1.5077,105,1.4969,0.6134,7207044,7207065
0.5136,0.275,1.8861,75,50,50,25,2.8098,1.5614,125,1.2484,0.6269,7207065,7207090
0.5146,0.353,1.625,90,45,60,30,2.9489,1.4432,135,1.5057,0.6204,7207090,7207117
0.4976,0.3945,1.9597,70,45,45,25,3.2759,1.5174,115,1.7584,0.626,7207117,7207140
0.5252,0.4559,1.8861,65,20,45,20,3.0615,1.6302,85,1.4313,0.6249,7207140,7207157
0.4878,0.3614,1.6302,95,35,75,20,2.9436,1.3665,130,1.577,0.5617,7222044,7222070
0.4881,0.3697,1.6367,75,25,50,25,2.6666,1.4359,100,1.2307,0.5648,7222070,7222090
0.4385,0.3945,1.4964,70,45,50,20,2.5886,1.3016,115,1.287,0.5447,7222090,7222113
0.4455,0.414,1.5721,85,55,60,25,2.9328,1.1352,140,1.7976,0.5549,7222113,7222141
0.4895,0.4049,1.5654,70,40,50,20,2.6857,1.3065,110,1.3792,0.5611,7222141,7222163
0.4659,0.3773,1.8212,75,50,50,25,2.9433,1.3145,125,1.6288,0.5643,7222163,7222188
0.4658,0.4053,1.695,80,35,45,35,2.983,1.3712,115,1.6119,0.5985,7222188,7222211
0.5094,0.2317,1.695,80,75,65,15,2.6795,1.4315,155,1.2481,0.6617,7244030,7244061
0.4619,0.3459,1.5006,90,50,60,30,2.5484,1.2418,140,1.3066,0.5773,7252052,7252080
0.4997,0.3533,1.7742,75,40,55,20,2.8615,1.4315,115,1.43,0.5436,8033141,8033164
0.5543,0.3695,1.8895,75,35,40,35,2.9528,1.43,110,1.5228,0.5415,8033164,8033186
0.5164,0.3925,1.8895,80,25,45,35,3.456,1.7562,105,1.6998,0.5661,8048111,8048132
0.5083,0.4134,1.8212,100,10,45,55,3.7108,1.7848,110,1.9259,0.5426,8048132,8048154
0.4947,0.3976,1.8861,70,0,45,25,3.1535,1.8861,70,1.2674,0.5263,8048154,8048168
0.5223,0.3435,1.7562,85,35,60,25,2.9969,1.56,120,1.4369,0.5256,8048168,8048192
0.522,0.3078,1.8488,90,20,60,30,2.9914,1.6302,110,1.3612,0.5594,8055150,8055172
0.5602,0.3241,2.4734,70,60,35,35,3.2512,1.8895,130,1.3617,0.582,8063034,8063060
0.5136,0.3493,2.0317,90,15,50,40,3.4074,1.8861,105,1.5212,0.5429,8070146,8070167
0.5253,0.3279,1.9543,70,50,45,25,2.8886,1.4315,120,1.4571,0.5843,8078017,8078041
0.504,0.3243,1.695,90,20,65,25,2.5039,1.5174,110,0.9865,0.5555,8078041,8078063
0.4827,0.4158,1.8895,65,30,45,20,3.2765,1.6457,95,1.6308,0.5373,8085072,8085091
0.5097,0.3018,1.6572,80,25,50,30,2.6811,1.6457,105,1.0354,0.5236,8115153,8115174
0.5238,0.3827,1.8385,65,20,50,15,2.7331,1.6302,85,1.1029,0.5499,8123109,8123126
0.562,0.3725,1.8488,70,45,45,25,2.8353,1.4315,115,1.4038,0.5324,8123126,8123149
0.5239,0.3405,1.545,90,20,60,30,2.6084,1.4315,110,1.1769,0.5126,8153027,8153049
0.5206,0.4568,1.8246,55,15,40,15,2.8472,1.69,70,1.1572,0.5194,8153177,8153191
0.474,0.3933,1.5299,90,15,45,45,2.9088,1.5006,105,1.4081,0.5297,8168115,8168136
0.4762,0.3786,1.6302,85,20,50,35,2.7331,1.3789,105,1.3542,0.5372,8168136,8168157
0.5179,0.287,1.9597,80,60,50,30,3.0148,1.5006,140,1.5142,0.5434,8198142,8198170
0.5322,0.3347,1.6912,85,40,50,35,2.9312,1.4432,125,1.4879,0.5442,8206124,8206149
0.5324,0.3096,1.8385,85,45,55,30,2.9325,1.56,130,1.3725,0.553,8206149,8206175
0.5217,0.3868,1.82,70,40,45,25,3.1373,1.5614,110,1.5759,0.5493,8206175,8206197
0.4782,0.3078,1.7742,90,35,65,25,2.8676,1.5006,125,1.3669,0.5484,8213125,8213150
0.5094,0.2881,1.5721,115,50,65,50,2.8103,1.3712,165,1.4392,0.569,8213150,8213183
0.4661,0.3393,1.8212,80,45,55,25,2.8029,1.4315,125,1.3714,0.569,8213183,8213208
0.4686,0.3389,1.6367,80,50,50,30,2.6935,1.34,130,1.3535,0.5584,8221078,8221104
0.4854,0.3508,1.8212,80,40,45,35,2.9732,1.4665,120,1.5067,0.5179,8228029,8228053
0.5248,0.2839,1.7848,100,40,60,40,2.8727,1.4432,140,1.4294,0.5171,8228053,8228081
0.4625,0.2903,1.9543,75,55,45,30,2.9647,1.5077,130,1.457,0.5137,8228081,8228107
0.4885,0.3557,1.721,70,45,50,20,2.8071,1.3712,115,1.4359,0.5454,8228107,8228130
0.499,0.3262,1.755,75,50,45,30,2.8659,1.3712,125,1.4947,0.5423,8228130,8228155
0.4692,0.3754,1.7848,65,50,40,25,2.9389,1.43,115,1.5089,0.5348,8228155,8228178
0.5272,0.4278,1.7658,65,30,50,15,2.6156,1.3789,95,1.2367,0.5604,8228178,8228197
0.4712,0.3471,1.7012,80,30,40,40,2.773,1.3789,110,1.3941,0.575,8228197,8228219
0.4669,0.3778,1.695,75,15,60,15,2.8152,1.5006,90,1.3145,0.5896,8236128,8236146
0.4724,0.3545,1.695,80,45,60,20,2.8364,1.3145,125,1.5219,0.5934,8236146,8236171
0.5,0.3447,1.7562,85,30,60,25,2.8718,1.34,115,1.5318,0.6082,8236171,8236194
0.4689,0.3785,1.8246,75,50,45,30,3.1914,1.4359,125,1.7555,0.5995,8236194,8236219
0.5076,0.3218,1.8895,80,35,60,20,2.6923,1.56,115,1.1323,0.5142,8243049,8243072
0.5427,0.2896,1.9028,85,65,55,30,3.0155,1.3665,150,1.649,0.509,8243072,8243102
0.4949,0.3235,2.081,80,45,50,30,2.9629,1.6367,125,1.3262,0.5298,8243102,8243127
0.5102,0.2988,1.9597,85,50,55,30,3.1877,1.4665,135,1.7212,0.5202,8243127,8243154
0.4667,0.3628,1.8385,70,35,40,30,3.2063,1.6263,105,1.58,0.5273,8243154,8243175
0.4783,0.4206,1.69,70,30,40,30,3.1373,1.4964,100,1.6409,0.5067,9033108,9033128
0.4864,0.4456,1.8951,60,25,40,20,2.8098,1.43,85,1.3798,0.5427,9093119,9093136
0.4783,0.378,1.7012,70,55,40,30,3.1373,1.3665,125,1.7708,0.5362,9093136,9093161
0.5357,0.4568,1.7658,70,15,50,20,2.8557,1.5006,85,1.355,0.5361,9093161,9093178
0.5333,0.4393,1.6263,65,25,45,20,2.9279,1.5006,90,1.4273,0.5388,9116182,9116200
0.5404,0.4479,1.6302,75,45,45,30,3.2562,1.3016,120,1.9546,0.5295,9123033,9123057
0.5069,0.3788,1.7099,75,45,50,25,3.0774,1.4432,120,1.6342,0.5636,9199046,9199070
0.5189,0.3175,1.8951,75,60,50,25,3.134,1.56,135,1.574,0.556,9199070,9199097
0.5,0.2283,1.8385,85,50,55,30,2.863,1.6263,135,1.2367,0.5507,9199097,9199124
0.477,0.3406,1.7848,75,30,45,30,2.8614,1.5614,105,1.3001,0.5367,9206190,9206211
0.5025,0.3763,1.8212,75,30,50,25,3.075,1.6457,105,1.4293,0.5511,9221180,9221201
0.5,0.2947,1.7598,85,25,50,35,2.8718,1.6302,110,1.2416,0.5039,9229031,9229053
0.4784,0.4314,1.4315,80,30,45,35,2.8662,1.235,110,1.6312,0.6377,10012030,10012052
0.4223,0.3625,1.3773,115,25,75,40,2.5385,1.105,140,1.4335,0.5949,10012159,10012187
0.4559,0.4575,1.7099,75,20,45,30,3.0078,1.365,95,1.6428,0.5927,10027096,10027115
0.4981,0.4986,1.5721,75,25,40,35,3.175,1.3712,100,1.8038,0.6061,10027115,10027135
0.4921,0.4392,1.7012,75,10,50,25,2.9181,1.5815,85,1.3366,0.6074,10027135,10027152
0.4841,0.4412,1.7598,80,25,50,30,2.9658,1.4359,105,1.5299,0.5951,10027152,10027173
0.4892,0.3865,1.6302,85,15,60,25,2.8027,1.4359,100,1.3668,0.5884,10027173,10027193
0.4337,0.3454,1.7848,75,30,50,25,2.7017,1.5174,105,1.1843,0.5904,10042176,10042197
0.5076,0.3973,1.6457,85,20,55,30,2.6923,1.4359,105,1.2564,0.5807,10072121,10072142
0.5073,0.3873,1.6302,85,45,50,35,2.9499,1.3665,130,1.5833,0.5959,10072142,10072168
0.5155,0.3948,1.7848,80,20,50,30,3.0265,1.4964,100,1.5301,0.5939,10072168,10072188
0.5088,0.3722,1.6302,80,25,50,30,2.8566,1.56,105,1.2966,0.5895,10072188,10072209
0.4815,0.3545,1.7658,60,55,35,25,2.7832,1.3789,115,1.4044,0.5962,10080071,10080094
0.5216,0.3475,1.9543,75,45,50,25,3.1252,1.4665,120,1.6587,0.5897,10080171,10080195
0.4331,0.3763,1.5654,90,15,40,50,3.0164,1.5614,105,1.455,0.6085,10095020,10095041
0.4762,0.463,1.7099,80,50,45,35,3.1421,1.1069,130,2.0352,0.5708,10102093,10102119
0.454,0.3368,1.8951,70,40,50,20,2.867,1.4964,110,1.3706,0.5677,10102119,10102141
0.4464,0.4278,1.721,70,60,45,25,3.0887,1.3016,130,1.7871,0.5717,10102141,10102167
0.4717,0.4237,1.4359,105,15,55,50,3.0439,1.3712,120,1.6727,0.57,10117023,10117047
0.5019,0.3955,1.6457,105,10,65,40,3.1321,1.4359,115,1.6962,0.5687,10117047,10117070
0.4626,0.3077,1.7742,75,30,50,25,2.8239,1.5721,105,1.2518,0.556,10117070,10117091
0.5231,0.3235,1.4964,75,45,50,25,2.6215,1.3065,120,1.315,0.565,10117091,10117115
0.4403,0.3367,1.7012,80,50,55,25,2.6736,1.3712,130,1.3024,0.568,10117115,10117141
0.4494,0.35,1.495,80,35,55,25,2.6396,1.1772,115,1.4624,0.5823,10117141,10117164
0.4505,0.3133,1.5815,75,55,45,30,2.6131,1.1861,130,1.427,0.5572,10117164,10117190
0.4505,0.3451,1.625,75,55,45,30,2.6131,1.1772,130,1.4359,0.5783,10117190,10117216
0.4981,0.411,1.885,65,55,40,25,3.0041,1.3016,120,1.7025,0.5881,10124103,10124127
0.4667,0.3961,1.8246,80,25,50,30,2.925,1.4964,105,1.4286,0.5776,10124127,10124148
0.4847,0.3148,1.755,65,40,50,15,2.5513,1.365,105,1.1863,0.5634,10124148,10124169
0.4649,0.3462,1.7562,80,70,50,30,2.7964,1.2367,150,1.5597,0.5671,10124169,10124199
0.4784,0.4013,1.7658,65,35,45,20,3.0013,1.4359,100,1.5654,0.5774,10139039,10139059
0.5091,0.4786,1.9028,60,35,40,20,3.2023,1.4964,95,1.7059,0.5876,10139121,10139140
0.5208,0.4454,1.9028,70,15,45,25,3.1227,1.6302,85,1.4925,0.5774,10139140,10139157
0.513,0.3339,1.9511,65,30,45,20,2.9391,1.6367,95,1.3025,0.572,10147131,10147150
0.5111,0.3021,1.8246,90,20,60,30,2.9279,1.7099,110,1.218,0.5881,10154035,10154057
0.5083,0.4098,1.8246,65,45,45,20,3.1971,1.5654,110,1.6317,0.5757,10154153,10154175
0.5416,0.3785,1.8861,70,30,45,25,3.1227,1.625,100,1.4977,0.5733,10154175,10154195
0.5576,0.3711,1.7562,70,10,50,20,2.8072,1.6912,80,1.116,0.5823,10154195,10154211
0.5495,0.3523,1.8861,75,35,45,30,3.0845,1.6457,110,1.4389,0.629,10162053,10162075
0.5406,0.3084,1.8304,70,40,45,25,2.8857,1.695,110,1.1908,0.5948,10162075,10162097
0.4868,0.4677,1.8246,60,45,40,20,2.9377,1.4315,105,1.5062,0.5904,10177088,10177109
0.5,0.3692,1.6457,85,10,55,30,2.7424,1.43,95,1.3124,0.5743,10177109,10177128
0.5235,0.4318,1.5077,80,30,50,30,2.7316,1.3712,110,1.3604,0.6116,10177128,10177150
0.546,0.4452,1.6912,65,35,40,25,2.867,1.43,100,1.437,0.601,10177150,10177170
0.5866,0.4034,1.8304,65,30,45,20,3.0245,1.5654,95,1.459,0.5826,10177170,10177189
0.5536,0.4366,1.5721,70,20,55,15,3.0615,1.7742,90,1.2874,0.5695,10177189,10177207
0.5106,0.3458,2.145,55,40,45,10,3.066,1.5721,95,1.4939,0.6988,10184030,10184049
0.5073,0.342,1.8861,75,15,45,30,2.9499,1.8951,90,1.0548,0.6737,10199085,10199103
0.4794,0.2607,2.0317,90,85,70,20,3.1214,1.3895,175,1.7319,0.5686,11004106,11004141
0.5025,0.2549,1.9511,70,40,55,15,2.6162,1.4964,110,1.1198,0.5639,11004141,11004163
0.5086,0.2525,1.6367,80,65,60,20,2.5686,1.3145,145,1.254,0.5775,11004163,11004192
0.5087,0.3732,1.721,90,40,55,35,3.069,1.4665,130,1.6026,0.6552,11012103,11012129
0.5694,0.3867,1.6263,80,10,55,25,3.0226,1.5614,90,1.4612,0.6316,11012129,11012147
0.5689,0.2724,2.1489,65,70,50,15,2.7515,1.5627,135,1.1888,0.6108,11019050,11019077
0.5794,0.3305,1.8951,75,60,50,25,2.9362,1.5654,135,1.3708,0.6019,11019077,11019104
0.5175,0.2896,2.2252,65,50,55,10,3.2022,1.7012,115,1.501,0.602,11019104,11019127
0.5446,0.2076,2.0962,80,60,55,25,2.7453,1.6572,140,1.0881,0.6095,11019127,11019155
0.5333,0.2553,1.8304,90,70,60,30,2.9279,1.495,160,1.4329,0.6086,11019155,11019187
0.5128,0.331,1.8212,70,35,45,25,2.8144,1.5654,105,1.249,0.6152,11027086,11027107
0.5283,0.3087,1.6263,85,40,65,20,2.707,1.4432,125,1.2638,0.611,11027107,11027132
0.4677,0.3381,2.081,65,75,45,20,3.1962,1.43,140,1.7662,0.5913,11027132,11027160
0.5248,0.3873,2.0244,55,45,40,15,2.8727,1.495,100,1.3777,0.5863,11027160,11027180
0.5019,0.3717,1.9543,60,50,45,15,3.0041,1.5077,110,1.4964,0.5751,11027180,11027202
0.5478,0.3902,2.0244,75,25,40,35,3.3559,1.8212,100,1.5348,0.6385,11042039,11042059
0.526,0.4106,2.1607,65,20,40,25,3.3365,1.8212,85,1.5154,0.625,11050060,11050077
0.4948,0.4073,2.0962,65,25,45,20,3.3078,1.755,90,1.5528,0.6079,11050077,11050095
0.519,0.3794,2.041,75,35,50,25,3.3813,1.6367,110,1.7446,0.6106,11050095,11050117
0.5199,0.372,1.9597,75,35,50,25,3.1256,1.755,110,1.3706,0.606,11050117,11050139
0.4901,0.4522,1.8861,60,20,40,20,3.2272,1.625,80,1.6022,0.6134,11050139,11050155
0.6109,0.3259,1.7562,65,40,50,15,2.5557,1.5815,105,0.9741,0.581,11050155,11050176
0.5323,0.4253,1.8246,65,20,50,15,2.811,1.4964,85,1.3145,0.6668,11057034,11057051
0.5866,0.3697,2.1538,55,55,50,5,3.0245,1.6263,110,1.3982,0.6121,11057141,11057163
0.4926,0.3227,2.2787,75,40,55,20,3.3407,1.7742,115,1.5665,0.5763,11057163,11057186
0.5193,0.3023,2.041,75,50,45,30,3.2567,1.6457,125,1.611,0.5847,11057186,11057211
0.5109,0.3374,1.8951,70,25,50,20,3.0564,1.755,95,1.3014,0.6191,11065041,11065060
0.5043,0.357,2.0841,65,55,45,20,3.1172,1.5614,120,1.5558,0.6197,11065060,11065084
0.5234,0.3865,1.8488,75,30,50,25,3.0036,1.5721,105,1.4315,0.6113,11065084,11065105
0.5537,0.4145,1.6302,80,20,50,30,3.0724,1.5721,100,1.5002,0.6237,11065105,11065125
0.5324,0.3733,2.0317,65,50,45,20,3.1697,1.7012,115,1.4685,0.6262,11065125,11065148
0.5434,0.387,2.041,65,25,45,20,2.9928,1.6875,90,1.3053,0.5874,11065148,11065166
0.4331,0.378,1.7562,100,25,90,10,3.5323,1.6263,125,1.906,0.5784,11065166,11065191
0.4493,0.4197,2.0962,65,60,35,30,3.8061,1.5299,125,2.2762,0.5792,11065191,11065216
0.541,0.3018,1.9511,80,30,45,35,3.1444,1.9886,110,1.1558,0.6163,11072025,11072047
0.5208,0.3572,1.9511,75,25,50,25,3.12,1.7012,100,1.4188,0.6151,11072047,11072067
0.5311,0.3723,1.8861,65,40,45,20,3.1914,1.625,105,1.5664,0.5998,11072067,11072088
0.5228,0.3668,2.016,70,55,40,30,3.5363,1.695,125,1.8413,0.6078,11072088,11072113
0.4887,0.3614,2.2186,65,40,45,20,3.3275,1.8488,105,1.4787,0.577,11072113,11072134
0.4793,0.3103,1.9028,80,40,50,30,2.9959,1.6263,120,1.3696,0.5858,11072134,11072158
0.5548,0.2999,1.8488,95,45,50,45,3.0485,1.4359,140,1.6126,0.5915,11072158,11072186
0.5043,0.3205,1.9511,75,60,55,20,3.1172,1.495,135,1.6222,0.5755,11080031,11080058
0.4689,0.3564,2.1695,70,50,45,25,3.0622,1.5721,120,1.4901,0.5655,11080058,11080082
0.5146,0.2971,1.7848,85,40,55,30,2.8246,1.4359,125,1.3887,0.5626,11080082,11080107
0.5197,0.3011,1.8895,65,65,50,15,3.0046,1.4534,130,1.5511,0.5651,11080107,11080133
0.485,0.337,2.1052,70,55,45,25,3.0941,1.5614,125,1.5328,0.5633,11080133,11080158
0.5174,0.4357,1.8861,65,35,45,20,3.0386,1.5006,100,1.538,0.5762,11080158,11080178
0.4886,0.3755,1.8895,80,35,45,35,3.2178,1.5721,115,1.6457,0.5668,11080178,11080201
0.5333,0.4214,1.8304,65,25,45,20,2.9279,1.5721,90,1.3558,0.539,11080201,11080219
0.5652,0.4282,1.7658,65,25,45,20,2.8753,1.6263,90,1.249,0.5952,11087107,11087125
0.5452,0.3595,2.1538,80,40,50,30,3.4571,1.625,120,1.8321,0.5702,11087125,11087149
0.4815,0.394,2.015,80,20,50,30,3.51,1.885,100,1.625,0.597,11087149,11087169
0.4994,0.46,1.7658,80,5,45,35,3.1268,1.69,85,1.4368,0.6004,11087169,11087186
0.5203,0.4939,1.625,65,10,50,15,2.8488,1.5614,75,1.2874,0.5821,11087186,11087201
0.5208,0.3682,1.5006,95,35,65,30,3.2666,1.4964,130,1.7702,0.6339,11102051,11102077
0.509,0.3775,1.8246,65,20,45,20,2.9396,1.7012,85,1.2384,0.6402,11102077,11102094
0.5153,0.4222,1.5614,85,15,60,25,3.1562,1.4964,100,1.6598,0.6349,11102094,11102114
0.4897,0.4038,1.7742,80,15,55,25,3.099,1.6263,95,1.4727,0.6344,11102114,11102133
0.4843,0.4038,1.8861,60,40,50,10,2.8184,1.5174,100,1.301,0.598,11102133,11102153
0.5028,0.4518,1.8246,80,25,50,30,3.3611,1.365,105,1.9961,0.5946,11102153,11102174
0.5371,0.4725,1.8246,65,10,45,20,3.1677,1.69,75,1.4777,0.6003,11102174,11102189
0.5473,0.4341,1.9769,65,25,45,20,3.4461,1.7012,90,1.7449,0.5952,11102189,11102207
0.5202,0.4138,1.8304,80,25,50,30,3.4108,1.6302,105,1.7806,0.5768,11110096,11110117
0.527,0.3925,1.7742,85,5,55,30,3.0235,1.7742,90,1.2493,0.5683,11110117,11110135
0.5403,0.4054,1.9028,60,30,45,15,2.8315,1.5935,90,1.238,0.5793,11110135,11110153
0.5666,0.3186,2.0841,75,55,45,30,3.1498,1.5299,130,1.6199,0.5547,11110153,11110179
0.5079,0.375,1.8488,55,25,40,15,3.0121,1.7848,80,1.2273,0.577,11110179,11110195
0.4939,0.3423,1.9769,70,40,50,20,3.0527,1.5299,110,1.5228,0.5643,11110195,11110217
0.5074,0.3758,1.8861,80,45,45,35,3.3407,1.6302,125,1.7105,0.5658,11125040,11125065
0.5292,0.4072,1.9511,65,35,35,30,3.3252,1.695,100,1.6302,0.5455,11125065,11125085
0.4885,0.3664,1.7848,75,30,45,30,3.0604,1.5721,105,1.4883,0.5564,11132024,11132045
0.556,0.3393,1.8385,70,35,45,25,2.9318,1.495,105,1.4368,0.5374,11132045,11132066
0.5714,0.3274,1.8895,65,35,50,15,2.73,1.56,100,1.17,0.529,11132199,11132219
0.4862,0.4053,1.7598,70,45,50,20,2.9533,1.4315,115,1.5219,0.5656,11147046,11147069
0.4994,0.3818,1.8895,65,55,35,30,3.1268,1.4359,120,1.6909,0.5668,11147069,11147093
0.4924,0.4361,1.8304,70,35,40,30,3.168,1.5614,105,1.6067,0.5663,11147093,11147114
0.4781,0.4684,1.6302,75,15,40,35,3.1533,1.56,90,1.5933,0.5695,11147114,11147132
0.4868,0.4784,1.7742,60,20,40,20,2.9377,1.5077,80,1.43,0.5812,11147132,11147148
0.445,0.4473,1.8212,55,40,40,15,3.0811,1.43,95,1.6511,0.576,11147148,11147167
0.5331,0.4649,1.6302,75,10,50,25,2.8152,1.3712,85,1.444,0.5677,11147167,11147184
0.5136,0.4744,1.8861,65,25,50,15,3.4074,1.5006,90,1.9067,0.553,11147184,11147202
0.5238,0.3852,1.69,75,40,50,25,2.7331,1.365,115,1.3681,0.5354,11155030,11155053
0.4282,0.3734,1.695,65,35,50,15,2.7493,1.4315,100,1.3179,0.5313,11155053,11155073
0.5795,0.4425,1.4964,60,45,45,15,2.4779,1.1772,105,1.3007,0.528,11155073,11155094
0.5839,0.4326,1.8385,55,40,45,10,2.674,1.4359,95,1.2381,0.5058,11155094,11155113
0.5367,0.3174,1.7562,85,25,60,25,2.9465,1.5815,110,1.365,0.5147,11162035,11162057
0.5636,0.4207,2.015,65,40,40,25,3.4772,1.82,105,1.6572,0.5351,11170103,11170124
0.5201,0.3416,2.0192,65,15,45,20,3.1269,1.9597,80,1.1672,0.5319,11170124,11170140
0.5226,0.3225,1.9511,65,40,35,30,2.9954,1.6263,105,1.3691,0.5404,11170140,11170161
0.4515,0.4244,1.8951,70,35,50,20,3.2192,1.5654,105,1.6538,0.5415,11170161,11170182
0.4692,0.4483,1.6912,65,30,55,10,2.9389,1.4534,95,1.4854,0.5392,11170182,11170201
0.5225,0.3466,1.8861,75,15,60,15,2.8718,1.6457,90,1.2261,0.5457,11178068,11178086
0.5106,0.3468,1.8951,70,40,50,20,3.066,1.5006,110,1.5654,0.5542,11178086,11178108
0.5428,0.3235,1.8212,70,30,60,10,2.7015,1.5654,100,1.1361,0.5539,11178108,11178128
0.5336,0.319,1.9886,70,65,50,20,2.8015,1.4665,135,1.335,0.5617,11178128,11178155
0.4874,0.3622,1.9886,75,30,55,20,3.0671,1.495,105,1.5721,0.5614,11178155,11178176
0.5074,0.2847,1.7682,80,40,60,20,2.821,1.495,120,1.326,0.5545,11178176,11178200
0.5248,0.3308,1.695,75,45,55,20,2.7359,1.3016,120,1.4343,0.5992,11185027,11185051
0.5118,0.3414,1.885,65,60,50,15,2.9321,1.4359,125,1.4962,0.5518,11185051,11185076
0.5122,0.2936,1.7742,80,25,50,30,2.6682,1.5006,105,1.1675,0.5762,11185076,11185097
0.5225,0.3757,1.7658,80,50,35,45,2.8718,1.3665,130,1.5053,0.5993,11185097,11185123
0.5111,0.486,1.8246,70,130,35,35,2.9279,1.9249,50,1.003,0.5831,11185176,11185186
0.5111,0.4211,1.5721,75,20,45,30,2.9279,1.4964,95,1.4315,0.5658,11185186,11185205
0.4949,0.4354,2.1927,60,20,45,15,3.4772,1.9028,80,1.5743,0.5562,11193183,11193199
0.554,0.3818,1.7598,65,25,50,15,2.6234,1.4315,90,1.192,0.5943,11200131,11200149
0.5113,0.2924,1.8861,70,60,45,25,2.9264,1.6263,130,1.3001,0.5666,11208029,11208055
0.496,0.2759,1.8385,95,60,55,40,2.9097,1.4964,155,1.4133,0.5768,11208055,11208086
0.5033,0.3291,2.0891,80,60,50,30,3.1104,1.4432,140,1.6672,0.5747,11208086,11208114
0.4534,0.3124,1.9597,80,35,50,30,3.0944,1.5654,115,1.529,0.5661,11208114,11208137
0.4606,0.3103,1.8951,65,60,50,15,2.8364,1.4032,125,1.4332,0.5844,11208137,11208162
0.4889,0.3012,1.8246,85,60,55,30,2.9279,1.3065,145,1.6214,0.6073,11208162,11208191
0.4939,0.3523,1.9543,70,60,45,25,3.0527,1.4315,130,1.6212,0.6126,11208191,11208217
0.5347,0.2868,1.8895,80,45,60,20,2.9602,1.4196,125,1.5406,0.5643,11215046,11215071
0.4775,0.2703,1.8212,80,45,60,20,2.8718,1.5829,125,1.289,0.5572,11215071,11215096
0.5032,0.3488,1.9597,70,70,55,15,3.1429,1.3712,140,1.7717,0.5653,11215096,11215124
0.5471,0.3671,2.1538,60,40,45,15,3.1703,1.6457,100,1.5246,0.6037,11223099,11223119
0.5097,0.3621,2.2759,60,40,40,20,3.3252,1.7344,100,1.5908,0.6194,11223119,11223139
0.5238,0.339,1.9543,80,25,45,35,3.1421,1.695,105,1.4471,0.6327,11223139,11223160
0.5147,0.3344,1.7562,65,30,50,15,2.6789,1.6457,95,1.0332,0.6366,11223160,11223179
0.5225,0.3586,1.7658,80,35,55,25,2.8718,1.4359,115,1.4359,0.5162,11230102,11230125
0.5146,0.269,1.8895,75,55,50,25,2.8246,1.365,130,1.4596,0.5692,11230153,11230179
0.509,0.3315,1.9597,65,55,45,20,2.9122,1.4534,120,1.4588,0.5927,11230179,11230203
0.4947,0.3824,1.7344,80,45,55,25,2.8907,1.2143,125,1.6764,0.6442,11238182,11238207
0.5302,0.3167,1.9391,60,60,50,10,2.8222,1.4315,120,1.3907,0.5822,11245038,11245062
0.4862,0.3057,2.0317,75,60,55,20,3.0779,1.4964,135,1.5815,0.5711,11245062,11245089
0.4768,0.3266,2.1052,65,70,40,25,3.4111,1.4964,135,1.9147,0.5617,11245089,11245116
0.5126,0.345,2.081,70,40,45,25,3.17,1.6263,110,1.5437,0.5586,11245116,11245138
0.5365,0.3637,1.9543,85,30,50,35,3.2736,1.625,115,1.6486,0.5526,11245138,11245161
0.46,0.3346,1.9028,80,25,55,25,3.1596,1.7562,105,1.4034,0.563,11245161,11245182
0.5318,0.3168,2.0891,80,50,50,30,3.3,1.4534,130,1.8466,0.5606,11245182,11245208
0.4774,0.3714,1.8304,85,30,45,40,3.2363,1.5815,115,1.6548,0.6281,12003019,12003042
0.4965,0.2855,1.8246,95,40,55,40,3.0139,1.545,135,1.4688,0.6263,12003042,12003069
0.5019,0.3115,1.7742,95,55,55,40,3.1321,1.4964,150,1.6357,0.6091,12003069,12003099
0.4933,0.3359,1.7099,95,30,60,35,3.1734,1.5721,125,1.6013,0.6128,12003099,12003124
0.5113,0.3262,1.8951,80,45,45,35,3.0618,1.5654,125,1.4964,0.6039,12003124,12003149
0.4917,0.34,1.8488,95,35,50,45,3.3469,1.5654,130,1.7815,0.5904,12003149,12003175
0.5115,0.3115,1.6912,100,30,65,35,3.0604,1.6457,130,1.4147,0.5969,12003175,12003201
0.5314,0.3733,1.7658,75,40,50,25,2.6935,1.4359,115,1.2577,0.623,12011038,12011061
0.5002,0.3222,1.8304,80,40,50,30,2.9914,1.4315,120,1.5599,0.6001,12011061,12011085
0.4727,0.3914,1.9597,85,40,55,30,3.506,1.4964,125,2.0096,0.6098,12011085,12011110
0.5026,0.3879,1.8385,75,25,45,30,3.233,1.6572,100,1.5758,0.6292,12011110,12011130
0.5131,0.3511,1.721,90,15,60,30,3.207,1.625,105,1.582,0.6127,12011130,12011151
0.5007,0.3671,2.0244,65,35,40,25,2.9971,1.5006,100,1.4964,0.5576,12026039,12026059
0.4798,0.3383,1.8895,65,40,45,20,2.8739,1.5006,105,1.3732,0.5369,12026059,12026080
0.4988,0.3661,1.9028,75,40,40,35,3.0083,1.3789,115,1.6294,0.5536,12026080,12026103
0.5499,0.3588,1.6711,75,15,50,25,2.6033,1.5006,90,1.1026,0.5673,12026103,12026121
0.4678,0.2927,1.7012,90,30,55,35,2.9312,1.6263,120,1.3049,0.6245,12033076,12033100
0.4887,0.3378,1.7598,75,65,60,15,2.9264,1.3712,140,1.5552,0.6206,12033100,12033128
0.4896,0.3411,1.6263,95,45,55,40,3.0564,1.43,140,1.6264,0.6148,12033128,12033156
0.5007,0.4077,1.6263,85,15,55,30,2.9971,1.4964,100,1.5006,0.6039,12033156,12033176
0.5204,0.3846,1.8304,70,40,55,15,2.8753,1.43,110,1.4453,0.6189,12041086,12041108
0.5427,0.352,1.7658,75,55,50,25,2.8745,1.2621,130,1.6125,0.5833,12041192,12041218
0.5099,0.4194,1.8895,75,30,55,20,3.2272,1.5006,105,1.7265,0.614,12056031,12056052
0.5002,0.3917,1.9769,70,30,45,25,3.1214,1.5654,100,1.5559,0.5769,12056145,12056165
0.5092,0.4242,1.9543,75,25,50,25,3.4462,1.5614,100,1.8849,0.5783,12056165,12056185
0.4838,0.4356,1.8385,80,20,45,35,3.5345,1.755,100,1.7795,0.5729,12056185,12056205
0.4699,0.4149,1.8304,75,30,45,30,3.3312,1.6457,105,1.6855,0.5857,12064037,12064058
0.498,0.376,1.7658,85,15,45,40,2.8747,1.5654,100,1.3093,0.5824,12064058,12064078
0.4664,0.3717,1.6367,80,20,55,25,2.8015,1.4315,100,1.37,0.5996,12064078,12064098
0.5,0.3421,1.9128,85,50,50,35,3.1308,1.3065,135,1.8243,0.6038,12064098,12064125
0.4951,0.3294,1.6263,75,40,45,30,2.7066,1.5654,115,1.1411,0.6148,12064125,12064148
0.5078,0.3747,1.695,85,35,45,40,3.0828,1.34,120,1.7428,0.6119,12064148,12064172
0.5108,0.4352,1.7598,75,15,45,30,2.9709,1.5654,90,1.4055,0.5974,12064172,12064190
0.5311,0.4528,1.6302,75,15,45,30,3.0622,1.5174,90,1.5448,0.5843,12064190,12064208
0.5277,0.4443,1.7742,85,35,50,35,3.4514,1.4432,120,2.0081,0.6443,12071030,12071054
0.4956,0.4413,1.8304,75,10,40,35,3.2447,1.8212,85,1.4235,0.6307,12071054,12071071
0.5077,0.4736,1.695,70,20,40,30,3.1385,1.608,90,1.5305,0.6154,12071071,12071089
0.4827,0.3549,1.8951,85,25,60,25,3.1087,1.5935,110,1.5152,0.623,12071089,12071111
0.4869,0.3519,1.7598,80,40,50,30,3.0822,1.5006,120,1.5815,0.6255,12071111,12071135
0.543,0.3687,1.6912,70,35,45,25,2.7945,1.5006,105,1.2938,0.6201,12071135,12071156
0.4672,0.3836,1.7658,80,25,65,15,3.0889,1.5174,105,1.5715,0.6118,12071156,12071177
0.4706,0.3829,2.0244,65,60,40,25,3.2509,1.4432,125,1.8077,0.5992,12071177,12071202
0.4828,0.3839,1.7848,85,55,45,40,3.2311,1.4359,140,1.7952,0.6118,12079020,12079048
0.4803,0.4283,1.7598,80,25,40,40,3.3861,1.56,105,1.8261,0.6153,12079048,12079069
0.52,0.4228,1.7099,90,10,50,40,3.2526,1.6263,100,1.6263,0.5952,12079069,12079089
0.4901,0.398,1.8246,85,25,45,40,3.4511,1.6912,110,1.7598,0.5978,12079089,12079111
0.4603,0.3694,1.6912,75,15,45,30,2.9792,1.6912,90,1.2879,0.6065,12079111,12079129
0.5085,0.3838,1.7742,85,40,55,30,3.1984,1.3712,125,1.8273,0.5966,12079129,12079154
0.5068,0.3762,1.695,90,25,55,35,3.2065,1.6263,115,1.5802,0.5855,12079154,12079177
0.5082,0.3948,1.7742,95,15,60,35,3.3279,1.625,110,1.7029,0.5854,12079177,12079199
0.5189,0.3796,1.8488,70,15,45,25,3.048,1.6912,85,1.3567,0.5868,12079199,12079216
0.5302,0.3727,1.8861,80,15,55,25,3.2089,1.695,95,1.5139,0.6133,12086028,12086047
0.4981,0.358,1.9028,65,30,45,20,3.1321,1.7012,95,1.4309,0.6111,12086047,12086066
0.5185,0.4107,1.8861,80,45,50,30,3.5124,1.56,125,1.9524,0.6103,12086066,12086091
0.4922,0.417,1.8385,70,20,50,20,3.3671,1.8212,90,1.5459,0.5867,12086091,12086109
0.4552,0.4836,1.9128,65,20,45,20,3.2564,1.6572,85,1.5992,0.5904,12086109,12086126
0.4881,0.4761,1.8861,70,25,50,20,3.3401,1.4822,95,1.8578,0.5947,12086126,12086145
0.5102,0.5056,1.6457,65,20,50,15,3.1877,1.6302,85,1.5575,0.588,12086145,12086162
0.5489,0.4403,1.9511,70,25,45,25,3.1994,1.6263,95,1.5731,0.5667,12086162,12086181
0.4815,0.4228,2.1607,65,25,50,15,3.5124,1.7562,90,1.7562,0.5696,12086181,12086199
0.5238,0.3647,1.7658,70,35,40,30,3.1421,1.5174,105,1.6246,0.5894,12116026,12116047
0.4604,0.3351,1.8385,75,30,55,20,3.1345,1.6457,105,1.4888,0.5972,12116047,12116068
0.541,0.3652,1.6457,70,30,50,20,2.5489,1.4432,100,1.1056,0.6076,12116068,12116088
0.5159,0.3992,1.6912,70,40,45,25,2.9658,1.3789,110,1.587,0.5933,12116088,12116110
0.4658,0.3537,1.5815,100,10,70,30,2.9604,1.5299,110,1.4305,0.5879,12116110,12116132
0.5115,0.3348,1.7099,95,35,55,40,3.0604,1.3789,130,1.6815,0.5758,12116132,12116158
0.4696,0.334,1.8304,85,40,55,30,3.1864,1.5654,125,1.621,0.5942,12116158,12116183
0.4988,0.3647,1.7562,85,30,50,35,3.0083,1.4964,115,1.5119,0.572,12116183,12116206
0.5685,0.3425,1.8951,85,15,55,30,3.0275,1.721,100,1.3065,0.5648,12131018,12131038
0.5441,0.3665,1.9597,65,35,45,20,3.0078,1.721,100,1.2869,0.5655,12131038,12131058
0.5446,0.3803,1.5654,75,50,55,20,2.7453,1.2367,125,1.5086,0.5741,12131126,12131151
0.4738,0.3844,1.695,65,40,45,20,2.884,1.495,105,1.389,0.5686,12131151,12131172
0.5007,0.3798,1.7658,80,45,50,30,2.9971,1.3665,125,1.6305,0.563,12131172,12131197
0.4674,0.3916,2.0891,65,50,45,20,3.2105,1.5077,115,1.7029,0.5624,12146026,12146049
0.4997,0.3665,1.6263,75,20,55,20,2.7315,1.5006,95,1.2309,0.5726,12146049,12146068
0.5108,0.4207,1.6263,70,50,50,20,2.9709,1.365,120,1.6059,0.5735,12146068,12146092
0.5192,0.4282,1.7742,60,35,45,15,2.8902,1.5174,95,1.3727,0.5646,12146092,12146111
0.5287,0.3727,1.8951,75,45,50,25,3.0836,1.5006,120,1.583,0.5575,12146111,12146135
0.491,0.3868,1.9543,60,30,45,15,2.9122,1.6302,90,1.282,0.5465,12146135,12146153
0.5331,0.3794,1.8951,60,50,50,10,2.9265,1.43,110,1.4965,0.5414,12146153,12146175
0.5319,0.4103,1.9673,70,35,55,15,3.3355,1.56,105,1.7755,0.5302,12146175,12146196
0.5349,0.349,1.82,70,30,40,30,2.795,1.6457,100,1.1493,0.5418,12169038,12169058
0.5166,0.3757,1.9543,65,40,40,25,2.9614,1.495,105,1.4664,0.5287,12169058,12169079
0.4733,0.4062,1.8951,70,35,50,20,2.9645,1.5299,105,1.4346,0.5123,12169079,12169100
0.5157,0.2731,1.8246,85,45,65,20,2.674,1.4032,130,1.2708,0.5231,12169100,12169126
0.5441,0.2568,1.9511,95,75,75,20,3.0245,1.3789,170,1.6457,0.5223,12169126,12169160
0.4669,0.3161,1.8212,70,60,55,15,2.8152,1.6457,130,1.1695,0.5484,12169160,12169186
0.4622,0.3334,2.016,75,70,55,20,3.1447,1.3145,145,1.8302,0.5423,12169186,12169215
0.513,0.3553,1.7099,80,45,50,30,2.9391,1.5077,125,1.4315,0.5347,12177044,12177069
0.4853,0.3353,1.5174,105,10,75,30,2.6789,1.5077,115,1.1712,0.554,12177069,12177092
0.5139,0.3393,1.365,105,35,70,35,2.7041,1.3,140,1.4041,0.5658,12177092,12177120
0.4783,0.2977,1.56,100,60,50,50,2.9928,1.3895,160,1.6033,0.5817,12177120,12177152
0.4737,0.3243,1.7598,80,45,45,35,2.8649,1.4315,125,1.4334,0.5817,12177152,12177177
0.4867,0.381,1.7344,75,35,55,20,2.9563,1.3572,110,1.599,0.5563,12177177,12177199
0.4725,0.381,1.9511,60,45,50,10,3.3271,1.5721,105,1.755,0.5549,12184026,12184047
0.5206,0.3494,2.0317,60,55,45,15,3.1214,1.5721,115,1.5493,0.5377,12184047,12184070
0.5245,0.2898,1.8861,80,40,55,25,2.8742,1.625,120,1.2492,0.5465,12184070,12184094
0.5408,0.3042,1.885,75,45,45,30,3.1271,1.5077,120,1.6195,0.5756,12184094,12184118
0.5111,0.3468,1.7848,70,30,45,25,2.9279,1.6912,100,1.2366,0.5841,12184118,12184138
0.4785,0.4147,1.7012,80,20,50,30,2.9915,1.4964,100,1.4951,0.5993,12184138,12184158
0.5261,0.439,1.7099,60,25,45,15,2.6062,1.4315,85,1.1747,0.5696,12184158,12184175
0.5821,0.3968,1.6912,70,25,45,25,2.7167,1.3712,95,1.3455,0.5561,12184175,12184194
0.4934,0.3515,1.8385,70,35,50,20,2.7697,1.5815,105,1.1882,0.5768,12184194,12184215
0.4993,0.3603,1.7848,70,35,60,10,2.9971,1.5721,105,1.4249,0.5888,12207035,12207056
0.4701,0.3595,1.721,100,20,80,20,3.1919,1.4964,120,1.6955,0.5913,12207056,12207080
0.5201,0.3782,1.9128,80,40,55,25,3.1269,1.5006,120,1.6263,0.5917,12207080,12207104
0.4882,0.33,1.9543,85,30,50,35,3.198,1.6263,115,1.5717,0.62,12207104,12207127
0.4909,0.3141,1.7099,85,25,55,30,2.8089,1.5614,110,1.2475,0.6234,12207127,12207149
0.4782,0.3738,1.7742,70,40,45,25,2.8676,1.3789,110,1.4887,0.629,12207149,12207171
0.4702,0.3927,1.5654,85,25,50,35,3.0695,1.3712,110,1.6984,0.6411,12207171,12207193
0.4846,0.3923,1.6367,70,30,55,15,2.8005,1.4432,100,1.3572,0.6254,12207193,12207213
0.4981,0.396,1.8212,70,35,45,25,3.0041,1.5077,105,1.4964,0.5889,12214037,12214058
0.4892,0.3293,1.7598,80,40,50,30,2.8027,1.4964,120,1.3062,0.5795,12214058,12214082
0.4902,0.3776,1.7012,80,45,55,25,2.9439,1.3712,125,1.5727,0.581,12214082,12214107
0.4976,0.4372,1.7012,70,30,50,20,2.9786,1.4432,100,1.5354,0.5874,12214107,12214127
0.513,0.4204,1.69,70,35,45,25,2.9391,1.4822,105,1.4569,0.5991,12214127,12214148
0.5106,0.4717,1.7562,60,30,40,20,3.066,1.5077,90,1.5584,0.5991,12214148,12214166
0.5028,0.4744,1.9028,70,20,40,30,3.3611,1.5654,90,1.7957,0.5834,12214166,12214184
0.5146,0.3893,1.755,70,15,45,25,2.8246,1.69,85,1.1346,0.6102,12214184,12214201
0.4883,0.2979,1.6572,90,40,55,35,2.6919,1.2621,130,1.4298,0.5777,12222036,12222062
0.4616,0.3084,1.7562,80,60,45,35,2.9027,1.3145,140,1.5882,0.5768,12222062,12222090
0.4838,0.3249,1.8385,70,50,60,10,2.77,1.34,120,1.43,0.5804,12222090,12222114
0.4539,0.3134,1.7099,90,45,60,30,2.8786,1.34,135,1.5386,0.6028,12222114,12222141
0.4474,0.3396,1.5174,85,25,60,25,2.47,1.3065,110,1.1635,0.6236,12222141,12222163
0.4617,0.4163,1.7598,65,45,50,15,2.8191,1.34,110,1.4791,0.5788,12229038,12229060
0.4892,0.4379,1.885,65,35,45,20,2.8027,1.3016,100,1.501,0.5876,12229060,12229080
0.4889,0.4281,1.5721,75,20,45,30,2.9279,1.3712,95,1.5567,0.5882,12229080,12229099
0.4472,0.4085,1.7742,80,30,55,25,3.1376,1.4315,110,1.7061,0.5904,12229099,12229121
0.4346,0.4234,1.5614,80,20,55,25,2.8766,1.4032,100,1.4734,0.5735,12229121,12229141
0.522,0.4014,1.7598,75,70,50,25,2.9914,1.2503,145,1.7411,0.5775,12229141,12229170
0.4773,0.3101,1.6457,85,35,50,35,2.863,1.5614,120,1.3016,0.5952,12229170,12229194
0.4879,0.355,1.5006,75,55,55,20,2.6777,1.1985,130,1.4791,0.5762,12237049,12237075
0.4763,0.33,1.69,85,55,55,30,2.8788,1.3065,140,1.5724,0.5954,12237075,12237103
0.4541,0.3849,1.6263,75,50,50,25,2.9192,1.3712,125,1.5481,0.6057,12237103,12237128
0.5,0.4103,1.6263,80,25,55,25,2.7424,1.3257,105,1.4166,0.5935,12237128,12237149
0.4676,0.4281,1.6457,70,45,45,25,2.9325,1.3712,115,1.5614,0.5652,12237149,12237172
0.5097,0.3537,1.6912,75,30,50,25,2.6811,1.3712,105,1.3099,0.5514,12237172,12237193
0.5461,0.3489,1.8488,70,55,55,15,2.8786,1.3665,125,1.5121,0.5544,12237193,12237218
0.5146,0.3488,1.7012,75,45,55,20,2.8246,1.5077,120,1.317,0.5974,13003045,13003069
0.5276,0.3351,1.6912,85,65,45,40,3.2124,1.4534,150,1.759,0.576,13003069,13003099
0.4702,0.3069,2.1607,65,45,45,20,3.0695,1.695,110,1.3745,0.5596,13003099,13003121
0.4992,0.3085,1.9769,75,60,55,20,2.8674,1.4432,135,1.4241,0.5671,13003121,13003148
0.5174,0.2945,2.0244,80,75,55,25,3.0386,1.4315,155,1.6071,0.5669,13003148,13003179
0.5217,0.2817,1.9769,90,55,55,35,2.9928,1.5721,145,1.4207,0.5639,13003179,13003208
0.4797,0.3929,1.3145,80,40,50,30,2.4542,1.1126,120,1.3416,0.6099,13011040,13011064
0.4666,0.371,1.4534,85,40,55,30,2.6614,1.1772,125,1.4842,0.6231,13011064,13011089
0.4987,0.3826,1.695,80,35,55,25,2.8791,1.4432,115,1.4359,0.5903,13049029,13049052
0.5104,0.348,1.9028,75,55,50,25,3.0564,1.4359,130,1.6205,0.5935,13049052,13049078
0.4972,0.3806,1.8385,80,35,60,20,3.0181,1.56,115,1.4581,0.5977,13049078,13049101
0.4751,0.4065,1.7562,70,35,45,25,3.013,1.5006,105,1.5124,0.589,13049101,13049122
0.4674,0.4086,1.8246,75,30,45,30,3.2105,1.4315,105,1.779,0.5997,13049122,13049143
0.4899,0.4043,1.7562,75,30,50,25,3.2088,1.5006,105,1.7082,0.5931,13049143,13049164
0.5159,0.4003,1.82,70,35,45,25,3.1601,1.5721,105,1.588,0.5873,13049164,13049185
0.483,0.4239,1.6912,70,15,55,15,2.9883,1.6302,85,1.3581,0.5854,13049185,13049202
0.4932,0.3939,1.7742,85,30,45,40,3.1021,1.5627,115,1.5394,0.6183,13056080,13056103
0.5216,0.3738,1.8385,80,25,55,25,2.9331,1.5299,105,1.4032,0.5989,13056103,13056124
0.4676,0.36,1.9028,70,30,45,25,2.9325,1.5299,100,1.4026,0.5935,13056124,13056144
0.5157,0.3674,1.8304,60,55,40,20,3.0278,1.3712,115,1.6566,0.5799,13056144,13056167
0.5216,0.3214,1.9028,80,35,60,20,3.0013,1.5614,115,1.44,0.5587,13056167,13056190
0.5579,0.3441,2.0244,65,35,50,15,3.0313,1.5654,100,1.4659,0.5845,13056190,13056210
0.5306,0.3431,1.8895,75,60,50,25,3.1877,1.5006,135,1.687,0.5867,13071029,13071056
0.5163,0.2946,2.0192,70,45,45,25,3.0319,1.6912,115,1.3406,0.5622,13071056,13071079
0.4617,0.3204,2.081,60,65,40,20,3.1763,1.5654,125,1.6109,0.5804,13071079,13071104
0.5217,0.3494,1.8246,80,35,55,25,2.9928,1.4665,115,1.5264,0.5738,13071104,13071127
0.4774,0.3897,1.885,65,30,45,20,2.9954,1.5614,95,1.4341,0.5862,13071127,13071146
0.4891,0.4257,1.695,85,35,50,35,2.9509,1.43,120,1.5209,0.5977,13071146,13071170
0.5291,0.3293,1.5815,90,35,55,35,2.6263,1.4432,125,1.183,0.5993,13071170,13071195
0.5157,0.3428,1.7598,80,30,50,30,3.0278,1.5006,110,1.5272,0.6069,13079041,13079063
0.4927,0.3762,1.6367,75,45,40,35,3.0801,1.5614,120,1.5188,0.5993,13079063,13079087
0.5217,0.2995,1.695,95,45,60,35,2.9928,1.5174,140,1.4754,0.5863,13079087,13079115
0.5111,0.3056,1.7012,90,30,50,40,2.9279,1.5614,120,1.3665,0.5866,13079115,13079139
0.4902,0.3365,1.7562,85,35,55,30,2.9439,1.4964,120,1.4475,0.5852,13079139,13079163
0.4953,0.3759,1.5006,85,20,55,30,2.8332,1.4315,105,1.4017,0.5929,13094084,13094105
0.513,0.3451,1.7099,80,45,50,30,2.9391,1.4032,125,1.536,0.5927,13094105,13094130
0.5327,0.4291,1.7012,75,25,45,30,3.0726,1.5077,100,1.5649,0.5922,13094130,13094150
0.5,0.4315,1.8385,75,15,45,30,3.1443,1.6367,90,1.5076,0.587,13094150,13094168
0.5147,0.4637,1.8385,70,15,45,25,3.0544,1.5721,85,1.4822,0.5855,13094168,13094185
0.5462,0.5139,1.8951,60,20,40,20,3.151,1.5721,80,1.5788,0.5487,13094185,13094201
0.474,0.4205,1.7742,70,15,45,25,3.0294,1.721,85,1.3084,0.5484,13094201,13094218
0.4965,0.3155,1.8488,90,65,55,35,3.0139,1.3665,155,1.6473,0.5687,13109034,13109065
0.5014,0.3214,1.8304,70,40,55,15,2.75,1.4964,110,1.2536,0.5702,13109065,13109087
0.4667,0.3339,1.8246,80,55,55,25,2.9279,1.3789,135,1.549,0.5549,13109087,13109114
0.5136,0.3412,1.8895,70,45,50,20,2.8098,1.3665,115,1.4432,0.5524,13109114,13109137
0.5224,0.3422,1.8385,70,50,50,20,2.8615,1.4432,120,1.4183,0.5677,13109137,13109161
0.4884,0.3436,1.8385,70,25,50,20,2.798,1.495,95,1.303,0.5598,13109161,13109180
0.5007,0.3724,1.8212,70,50,45,25,2.9971,1.3665,120,1.6305,0.5677,13109180,13109204
0.4992,0.3252,1.8951,70,50,50,20,2.8674,1.5299,120,1.3375,0.553,13124038,13124062
0.5,0.3697,1.6367,80,30,55,25,2.7424,1.4315,110,1.3109,0.5495,13124062,13124084
0.5116,0.3093,1.7099,85,40,55,30,2.798,1.3712,125,1.4268,0.5538,13124084,13124109
0.5338,0.3369,1.5174,85,20,60,25,2.6818,1.4315,105,1.2503,0.5559,13124109,13124130
0.5157,0.3563,1.7598,75,65,50,25,3.0899,1.4315,140,1.6584,0.54,13124130,13124158
0.5171,0.4029,1.8304,80,20,55,25,3.1424,1.5935,100,1.5489,0.5219,13124158,13124178
0.4979,0.3567,1.7658,80,20,50,30,3.0027,1.625,100,1.3777,0.5242,13124178,13124198
0.4899,0.3459,1.8212,65,25,55,10,2.5519,1.495,90,1.0569,0.5281,13124198,13124216
0.4796,0.4438,1.9543,65,30,40,25,3.2783,1.7742,95,1.5042,0.5482,13131031,13131050
0.5067,0.4772,1.8246,65,25,40,25,3.2302,1.5721,90,1.658,0.5448,13131050,13131068
0.5216,0.4416,1.7658,70,15,50,20,3.0013,1.6367,85,1.3646,0.5409,13131068,13131085
0.5008,0.3856,1.6302,65,20,45,20,2.7377,1.5654,85,1.1723,0.546,13131085,13131102
0.4929,0.4096,1.7598,70,40,50,20,3.0788,1.3712,110,1.7076,0.5498,13131102,13131124
0.5424,0.3836,1.8951,65,40,45,20,3.125,1.5174,105,1.6076,0.5407,13131124,13131145
0.5191,0.3599,2.1607,65,45,45,20,3.2554,1.695,110,1.5604,0.533,13131145,13131167
0.523,0.3744,2.0891,70,35,50,20,3.1463,1.69,105,1.4563,0.533,13131167,13131188
0.5006,0.3975,2.1489,65,40,45,20,3.2565,1.6457,105,1.6108,0.5336,13131188,13131209
0.5,0.3617,1.8895,75,15,45,30,3.0153,1.6912,90,1.3241,0.5672,13139034,13139052
0.4633,0.3526,1.7598,80,35,40,40,2.9465,1.5077,115,1.4389,0.5652,13139052,13139075
0.5266,0.3351,1.695,70,40,45,25,2.7599,1.365,110,1.3949,0.5569,13139075,13139097
0.4884,0.4107,1.695,85,30,50,35,3.0728,1.4534,115,1.6193,0.5558,13139097,13139120
0.4881,0.379,1.7658,65,30,50,15,2.7965,1.5006,95,1.2958,0.5604,13139120,13139139
0.5,0.3774,1.6457,80,25,45,35,2.8392,1.365,105,1.4742,0.5926,13139139,13139160
0.4877,0.472,1.6263,75,25,45,30,3.0686,1.4196,100,1.6489,0.5794,13139160,13139180
0.4635,0.4253,1.695,70,20,45,25,2.9481,1.4964,90,1.4517,0.5643,13139180,13139198
0.449,0.3045,1.7012,85,35,55,30,2.6059,1.3257,120,1.2802,0.5366,13177026,13177050
0.4883,0.3707,1.5815,80,45,55,25,2.7153,1.3145,125,1.4007,0.5475,13184023,13184048
0.5027,0.3379,1.7848,85,60,55,30,2.9487,1.3257,145,1.6229,0.5611,13184048,13184077
0.4867,0.3414,1.5006,85,25,50,35,2.6712,1.4822,110,1.1889,0.5544,13184077,13184099
0.4625,0.3489,1.56,85,25,55,30,2.6851,1.3,110,1.3851,0.5631,13184099,13184121
0.478,0.3948,1.721,70,45,45,25,2.9914,1.2418,115,1.7495,0.5579,13184121,13184144
0.5121,0.3825,1.6263,85,20,55,30,2.9306,1.43,105,1.5006,0.5545,13184144,13184165
0.511,0.3683,1.7012,80,30,55,25,2.9365,1.5006,110,1.4359,0.5493,13184165,13184187
0.5002,0.3443,1.9673,75,45,50,25,2.9914,1.43,120,1.5614,0.5808,13207180,13207204
0.4752,0.3727,1.6302,65,40,50,15,2.4772,1.2367,105,1.2405,0.5741,13222088,13222109
0.4392,0.4311,1.7658,65,35,55,10,2.6682,1.1772,100,1.491,0.5797,13222109,13222129
0.5076,0.3652,1.7742,60,65,40,20,2.64,1.1718,125,1.4682,0.5782,13222129,13222154
0.4804,0.3846,1.7598,75,45,50,25,2.9206,1.34,120,1.5806,0.5999,13222154,13222178
0.4208,0.2983,1.7344,65,60,45,20,2.6979,1.4032,125,1.2947,0.6239,13222178,13222203
0.513,0.3069,1.7598,100,60,55,45,2.9391,1.3712,160,1.568,0.545,13229043,13229075
0.4647,0.2912,1.6367,95,10,60,35,2.5527,1.5077,105,1.045,0.5623,13229075,13229096
0.4742,0.3137,1.5654,75,65,55,20,2.6079,1.1861,140,1.4217,0.5625,13229096,13229124
0.4448,0.383,1.695,80,60,60,20,2.9266,1.2367,140,1.6899,0.57,13229124,13229152
0.4768,0.4486,1.95,60,75,40,20,3.1085,1.3016,135,1.8069,0.5915,13229152,13229179
0.463,0.3492,1.6302,90,15,50,40,2.8077,1.4822,105,1.3254,0.5837,13229179,13229200
0.5083,0.3665,2.016,70,40,50,20,3.3469,1.7658,110,1.5811,0.6128,14003099,14003121
0.4959,0.3646,1.95,70,30,50,20,3.2874,1.7012,100,1.5862,0.605,14003121,14003141
0.445,0.3705,2.0192,70,35,50,20,3.0811,1.6302,105,1.4509,0.6043,14003141,14003162
0.4803,0.3803,1.8488,80,40,55,25,3.0046,1.3712,120,1.6334,0.5892,14003162,14003186
0.4854,0.3534,1.8304,75,50,55,20,2.9732,1.4432,125,1.5299,0.5962,14003186,14003211
0.5509,0.3093,2.0962,70,40,50,20,3.1241,1.7742,110,1.35,0.5624,14011136,14011158
0.5106,0.2754,1.9597,90,30,65,25,3.0578,1.721,120,1.3368,0.5474,14011158,14011182
0.4988,0.2516,2.0244,80,65,50,30,3.0083,1.5614,145,1.447,0.5359,14011182,14011211
0.4519,0.3441,1.7742,85,35,50,35,2.965,1.4196,120,1.5454,0.6397,14018051,14018075
0.5005,0.3369,1.5815,90,40,55,35,2.8033,1.34,130,1.4633,0.6385,14018075,14018101
0.4861,0.3547,1.5006,95,25,65,30,2.8082,1.4032,120,1.4051,0.6077,14018101,14018125
0.5348,0.3561,1.9673,70,60,55,15,2.798,1.365,130,1.433,0.6105,14018125,14018151
0.5161,0.3428,1.8304,80,50,55,25,3.1157,1.4964,130,1.6193,0.605,14018151,14018177
0.523,0.3338,1.9673,75,40,60,15,2.8614,1.608,115,1.2534,0.6126,14018177,14018200
0.488,0.3426,1.8212,85,35,50,35,3.0892,1.5006,120,1.5885,0.6185,14026031,14026055
0.513,0.344,1.7658,70,35,45,25,2.9391,1.5077,105,1.4315,0.6219,14026055,14026076
0.4934,0.3781,1.9511,65,45,45,20,3.3357,1.5077,110,1.828,0.6065,14026076,14026098
0.5507,0.3374,1.9511,65,35,50,15,3.1957,1.6457,100,1.55,0.5781,14026098,14026118
0.5146,0.3631,1.8385,65,15,45,20,2.9489,1.7598,80,1.1891,0.5946,14026118,14026134
0.487,0.4247,1.8895,55,40,45,10,3.0115,1.5174,95,1.4941,0.5983,14026134,14026153
0.4808,0.3958,2.0962,60,55,40,20,3.3145,1.4665,115,1.848,0.5805,14026153,14026176
0.513,0.2933,1.8304,80,15,55,25,2.6728,1.5935,95,1.0793,0.5839,14026176,14026195
0.5141,0.2953,1.7742,110,35,55,55,2.7931,1.5299,145,1.2632,0.6284,14033123,14033152
0.5467,0.3708,1.7012,85,45,50,35,2.9939,1.4359,130,1.558,0.6138,14033152,14033178
0.524,0.3243,2.1489,75,45,55,20,3.1407,1.6367,120,1.504,0.5862,14033178,14033202
0.5021,0.3015,1.8385,80,35,60,20,2.8511,1.6367,115,1.2144,0.5956,14041147,14041170
0.5129,0.4268,1.7598,75,25,45,30,3.2084,1.4964,100,1.712,0.6804,14048033,14048053
0.4914,0.3723,1.9028,75,35,50,25,3.2182,1.6572,110,1.561,0.6005,14048118,14048140
0.4312,0.3636,2.1607,60,55,45,15,3.3161,1.5815,115,1.7346,0.6072,14048140,14048163
0.5238,0.3618,1.9673,90,45,50,40,3.5096,1.43,135,2.0796,0.6032,14048163,14048190
0.5097,0.3435,1.9511,75,30,50,25,3.3252,1.8385,105,1.4867,0.5924,14048190,14048211
0.5528,0.3649,2.0192,65,45,40,25,3.0662,1.495,110,1.5712,0.6509,14056044,14056066
0.4947,0.3855,2.0244,65,15,50,15,3.0926,1.695,80,1.3976,0.6349,14056066,14056082
0.4815,0.3781,2.0192,80,40,45,35,3.442,1.5299,120,1.9121,0.6274,14056082,14056106
0.4902,0.4534,1.8895,70,20,45,25,3.3175,1.6572,90,1.6604,0.623,14056106,14056124
0.5109,0.4076,1.95,65,20,45,20,3.0564,1.6263,85,1.4301,0.6338,14056124,14056141
0.5304,0.3873,1.6912,90,20,45,45,3.1956,1.5614,110,1.6343,0.6153,14056141,14056163
0.4981,0.3396,1.8246,90,5,50,40,3.0041,1.695,95,1.3091,0.5998,14056163,14056182
0.5211,0.3623,1.82,85,40,50,35,3.4043,1.4964,125,1.9079,0.6172,14056182,14056207
0.5131,0.4299,1.7099,80,15,45,35,3.0822,1.5006,95,1.5815,0.6454,14064132,14064151
0.507,0.366,1.6367,90,5,50,40,2.9484,1.5815,95,1.3669,0.6483,14064151,14064170
0.5319,0.4188,1.6263,80,25,55,25,3.0578,1.495,105,1.5628,0.6246,14064170,14064191
0.4959,0.422,1.8951,70,30,45,25,3.2874,1.6263,100,1.6611,0.6079,14064191,14064211
0.515,0.3464,1.8385,75,55,45,30,3.0941,1.365,130,1.7291,0.6858,14079101,14079127
0.5069,0.3126,1.7742,105,20,40,65,3.0774,1.5935,125,1.4839,0.6742,14079127,14079152
0.506,0.3032,1.695,115,15,45,70,3.1279,1.56,130,1.5679,0.6894,14079152,14079178
0.4658,0.421,1.695,75,10,50,25,2.983,1.5829,85,1.4002,0.6611,14079178,14079195
0.479,0.4087,1.2418,85,25,55,30,2.7445,1.3895,110,1.355,0.6518,14079195,14079217
0.532,0.3902,1.8895,75,20,50,25,3.1976,1.7658,95,1.4318,0.5857,14094036,14094055
0.4982,0.3368,1.8895,80,35,50,30,3.2617,1.7012,115,1.5604,0.578,14094055,14094078
0.4689,0.3533,1.9597,75,35,55,20,3.1914,1.625,110,1.5664,0.5955,14094078,14094100
0.4416,0.3473,1.9249,70,55,45,25,3.2679,1.4964,125,1.7715,0.5751,14094100,14094125
0.4713,0.355,2.0841,65,45,50,15,3.3216,1.7598,110,1.5618,0.6083,14101042,14101064
0.5028,0.3717,1.8385,65,35,45,20,3.0181,1.5654,100,1.4527,0.6584,14101064,14101084
0.4212,0.3775,1.755,75,45,50,25,3.2739,1.5174,120,1.7565,0.6351,14101084,14101108
0.4892,0.3071,1.7344,80,35,45,35,2.8027,1.4964,115,1.3062,0.5796,14109106,14109129
0.5098,0.4125,1.7012,85,35,45,40,3.3175,1.3712,120,1.9464,0.5782,14109129,14109153
0.5102,0.426,1.8385,75,10,50,25,3.1877,1.6912,85,1.4964,0.5742,14109153,14109170
0.4889,0.4478,1.6302,80,5,55,25,3.2021,1.6263,85,1.5758,0.588,14109170,14109187
0.5111,0.4085,1.7012,80,15,50,30,2.9279,1.5654,95,1.3625,0.579,14109187,14109206
0.5317,0.3865,1.8895,65,35,50,15,3.0661,1.56,100,1.5061,0.5777,14116075,14116095
0.5125,0.3294,2.081,70,50,50,20,3.3362,1.6302,120,1.706,0.5714,14116095,14116119
0.5,0.351,2.1489,65,50,40,25,3.3825,1.7099,115,1.6726,0.5533,14116119,14116142
0.5287,0.3353,2.041,80,35,50,30,3.1989,1.6912,115,1.5077,0.5681,14116142,14116165
0.4545,0.3581,1.8951,80,35,45,35,3.575,1.6912,115,1.8838,0.5667,14116165,14116188
0.5074,0.3652,1.695,105,10,95,10,3.3407,1.625,115,1.7157,0.5961,14116188,14116211
0.5058,0.3849,1.6912,70,25,40,30,2.8391,1.5815,95,1.2575,0.5697,14131135,14131154
0.4865,0.4112,1.3789,85,25,60,25,2.856,1.3789,110,1.4771,0.6284,14139044,14139066
0.5116,0.4154,1.5654,80,25,45,35,2.798,1.3895,105,1.4085,0.6121,14139066,14139087
0.4811,0.5076,1.8212,70,20,40,30,3.134,1.4315,90,1.7025,0.6401,14139087,14139105
0.4845,0.4286,1.5006,80,10,50,30,2.9516,1.5077,90,1.4439,0.6165,14139105,14139123
0.476,0.416,1.6912,75,30,45,30,2.9195,1.43,105,1.4895,0.6156,14139123,14139144
0.479,0.403,1.4964,85,20,55,30,2.7445,1.3895,105,1.355,0.6278,14139144,14139165
0.4688,0.4294,1.4964,70,25,50,20,2.6921,1.3145,95,1.3775,0.6198,14139165,14139184
0.474,0.3862,1.6457,75,30,55,20,2.4837,1.2621,105,1.2216,0.6056,14139184,14139205
0.5328,0.2422,1.9597,95,50,50,45,3.0889,1.625,145,1.4639,0.602,14146034,14146063
0.5058,0.2454,2.1052,80,60,60,20,3.0249,1.6457,140,1.3792,0.5715,14146063,14146091
0.5187,0.2667,2.1538,55,90,40,15,3.1327,1.5299,145,1.6027,0.5569,14146091,14146120
0.5216,0.3578,1.9597,60,40,45,15,3.0013,1.625,100,1.3763,0.5676,14146120,14146140
0.5106,0.3748,2.0317,55,45,45,10,3.0578,1.5654,100,1.4924,0.5526,14146140,14146160
0.4989,0.445,1.9128,60,30,45,15,3.1375,1.5614,90,1.5762,0.584,14146160,14146178
0.5236,0.4931,1.9597,65,25,45,20,3.4783,1.5654,90,1.9129,0.5694,14146178,14146196
0.4843,0.3941,2.0192,65,10,55,10,3.0899,1.8212,75,1.2687,0.566,14146196,14146211
0.5292,0.3966,1.8951,70,20,40,30,3.2027,1.7658,90,1.4369,0.5779,14154054,14154072
0.4992,0.4141,1.7658,85,15,45,40,3.2552,1.695,100,1.5602,0.5625,14154072,14154092
0.476,0.4729,1.7658,65,20,50,15,3.1407,1.625,85,1.5157,0.5688,14154092,14154109
0.4889,0.5048,1.8951,60,35,50,10,3.2021,1.495,95,1.7071,0.5569,14154109,14154128
0.5514,0.4236,1.95,55,45,40,15,3.0739,1.5654,100,1.5084,0.5387,14154128,14154148
0.466,0.3518,1.8212,85,15,60,25,3.0816,1.695,100,1.3866,0.5421,14154148,14154168
0.5007,0.3237,1.7562,85,40,60,25,2.9971,1.4359,125,1.5612,0.5573,14154168,14154193
0.5118,0.3123,1.7562,85,40,55,30,2.9321,1.5006,125,1.4315,0.5509,14154193,14154218
0.447,0.3928,1.7562,60,40,45,15,2.7666,1.3145,100,1.4521,0.5635,14161094,14161114
0.5103,0.3545,1.5815,95,40,55,40,3.099,1.2367,135,1.8622,0.5957,14161114,14161141
0.4906,0.3491,1.7658,80,45,50,30,3.0731,1.5815,125,1.4916,0.5733,14161141,14161166
0.4981,0.3665,1.8246,80,30,55,25,3.0041,1.5077,110,1.4964,0.5776,14161166,14161188
0.4865,0.3948,1.8246,70,25,55,15,2.856,1.4964,95,1.3596,0.5864,14161188,14161207
0.5003,0.3472,1.8861,75,45,50,25,2.7315,1.3665,120,1.365,0.5763,14169171,14169195
0.4993,0.3884,1.8304,75,25,45,30,2.9971,1.56,100,1.4371,0.5899,14176020,14176040
0.531,0.3425,1.7742,80,20,55,25,2.8574,1.4964,100,1.361,0.5937,14176040,14176060
0.4988,0.3832,1.7598,80,45,50,30,3.0083,1.5174,125,1.4909,0.6046,14176060,14176085
0.5183,0.396,1.6263,80,25,50,30,2.8845,1.5006,105,1.3839,0.5867,14176085,14176106
0.5218,0.3852,1.8304,65,35,45,20,2.8676,1.495,100,1.3726,0.5884,14176106,14176126
0.5325,0.4064,1.7099,75,30,50,25,3.0617,1.4964,105,1.5653,0.5784,14176126,14176147
0.5126,0.3541,1.8304,85,25,55,30,3.0671,1.6302,110,1.4369,0.5838,14176147,14176169
0.4759,0.4008,1.8246,80,15,50,30,3.0174,1.5721,95,1.4453,0.6013,14176169,14176188
0.5082,0.3778,1.8246,70,25,40,30,2.8254,1.4359,95,1.3895,0.5977,14176188,14176207
0.4866,0.3627,1.8613,80,30,45,35,3.1752,1.5614,110,1.6139,0.5747,14184037,14184059
0.4991,0.3221,1.9128,85,40,50,35,3.1254,1.545,125,1.5804,0.5601,14184059,14184084
0.4948,0.364,1.8304,80,30,55,25,3.3078,1.56,110,1.7478,0.5713,14184084,14184106
0.4884,0.3736,1.9769,75,35,55,20,3.0728,1.6367,110,1.4361,0.5813,14184106,14184128
0.5,0.435,1.8861,60,15,40,20,3.0013,1.7099,75,1.2914,0.5823,14184192,14184207
0.4788,0.3303,1.6367,85,25,50,35,2.769,1.5006,110,1.2683,0.6225,14207046,14207068
0.5308,0.2896,1.5654,105,65,55,50,2.9617,1.3257,170,1.6359,0.6347,14207068,14207102
0.5088,0.3086,1.7658,80,40,55,25,2.8566,1.5721,120,1.2845,0.6289,14207102,14207126
0.5102,0.361,1.7658,85,40,55,30,3.1234,1.4534,125,1.67,0.6388,14207126,14207151
0.5122,0.3809,1.8385,65,25,45,20,2.6682,1.5935,90,1.0747,0.6436,14207151,14207169
0.4715,0.3309,1.9511,85,75,50,35,3.3115,1.3065,160,2.005,0.623,14214120,14214152
0.4625,0.3947,1.695,75,35,50,25,2.9647,1.5174,110,1.4472,0.6145,14222031,14222053
0.4704,0.3581,1.7562,80,60,50,30,3.0901,1.3712,140,1.7189,0.6221,14222053,14222081
0.4962,0.2831,1.8861,90,50,50,40,2.8849,1.4534,140,1.4315,0.6559,14222081,14222109
0.5105,0.2843,1.695,95,30,60,35,2.6857,1.4315,125,1.2542,0.6537,14222109,14222134
0.5237,0.3168,1.7012,95,35,60,35,2.8788,1.3712,130,1.5077,0.6648,14222134,14222160
0.4137,0.3603,1.7598,85,30,50,35,3.3332,1.5077,115,1.8255,0.6502,14222160,14222183
0.5486,0.3176,1.7099,90,30,55,35,2.7356,1.3789,120,1.3568,0.6524,14222183,14222207
0.4884,0.3954,1.8212,75,30,55,20,3.0728,1.5721,105,1.5006,0.6242,14229043,14229064
0.4792,0.4179,1.7658,80,25,55,25,3.1227,1.5006,105,1.6221,0.6107,14229064,14229085
0.4752,0.3491,1.8304,80,25,50,30,2.8727,1.4964,105,1.3763,0.6098,14229085,14229106
0.5398,0.3901,1.7742,75,40,55,20,3.0197,1.365,115,1.6547,0.6272,14229106,14229129
0.4823,0.4149,2.0192,65,35,45,20,3.2596,1.6302,100,1.6294,0.6037,14229129,14229149
0.4426,0.3869,1.7012,80,20,60,20,3.0875,1.5721,100,1.5154,0.5934,14229149,14229169
0.5465,0.3684,1.6367,80,30,50,30,2.7382,1.3665,110,1.3717,0.6165,14229169,14229191
0.4874,0.3916,1.885,65,45,40,25,3.0671,1.4964,110,1.5707,0.6305,14229191,14229213
0.4881,0.3189,1.7658,85,25,55,30,2.6666,1.4964,110,1.1702,0.5873,14244188,14244210
0.4897,0.3916,1.7012,80,10,55,25,2.9323,1.5174,90,1.4149,0.5585,15004164,15004182
0.5108,0.3692,1.7598,75,35,55,20,2.9709,1.5299,110,1.441,0.5734,15019065,15019087
0.535,0.4303,1.885,65,30,50,15,2.9387,1.5174,95,1.4212,0.5653,15019087,15019106
0.5006,0.4297,1.9511,60,40,40,20,3.2565,1.5721,100,1.6844,0.5683,15019106,15019126
0.5353,0.4191,1.755,70,20,55,15,2.9371,1.6302,90,1.3069,0.5669,15019126,15019144
0.5531,0.3801,1.8895,75,30,55,20,3.0578,1.5721,105,1.4857,0.5629,15019144,15019165
0.5495,0.3966,2.1538,65,45,45,20,3.3311,1.6912,110,1.6398,0.5499,15019165,15019187
0.4791,0.3853,2.1538,55,30,45,10,2.9973,1.8304,85,1.1668,0.5525,15019187,15019204
0.4812,0.4082,1.9543,75,25,45,30,3.4198,1.7658,100,1.654,0.6133,15035050,15035070
0.4729,0.4158,2.016,65,45,35,30,3.5845,1.6457,110,1.9388,0.5973,15035070,15035092
0.4783,0.3441,1.8304,75,30,50,25,3.1373,1.695,105,1.4423,0.5889,15035092,15035113
0.4917,0.3909,1.6912,75,40,45,30,3.1114,1.5006,115,1.6108,0.5939,15035113,15035136
0.5296,0.3904,1.7099,70,30,45,25,3.0901,1.5299,100,1.5602,0.5828,15035136,15035156
0.478,0.2885,1.8861,85,40,60,25,2.907,1.6367,125,1.2703,0.5889,15035156,15035181
0.4819,0.3593,1.7099,85,35,60,25,2.8611,1.3895,120,1.4715,0.5834,15035181,15035205
0.5223,0.328,1.8385,70,25,50,20,2.8865,1.6912,95,1.1953,0.6045,15042137,15042156
0.4889,0.364,1.7562,65,45,50,15,2.9279,1.5077,110,1.4202,0.5916,15042156,15042178
0.4733,0.4408,1.9249,70,20,45,25,3.3413,1.7598,90,1.5815,0.5525,15050034,15050052
0.5,0.427,1.9597,60,30,40,20,3.1308,1.5815,90,1.5493,0.5672,15050052,15050070
0.4912,0.4244,1.6367,85,30,50,35,3.3317,1.5654,115,1.7662,0.5992,15050070,15050093
0.5425,0.4236,2.0891,60,30,35,25,3.2706,1.6367,90,1.6339,0.5737,15050093,15050111
0.5651,0.4184,1.8951,70,35,40,30,3.4506,1.7742,105,1.6765,0.5456,15050111,15050132
0.5166,0.374,2.0962,70,20,45,25,3.2715,1.95,90,1.3215,0.5542,15050132,15050150
0.508,0.3728,1.8861,80,35,50,30,3.4574,1.69,115,1.7674,0.5506,15050150,15050173
0.5551,0.3423,1.9511,75,20,55,20,2.9367,1.7562,95,1.1805,0.5486,15050173,15050192
0.4964,0.3569,2.146,75,55,40,35,3.4443,1.6302,130,1.8141,0.5551,15050192,15050218
0.5159,0.3039,1.8212,80,50,55,25,3.0885,1.5721,130,1.5164,0.6219,15057045,15057071
0.494,0.3341,1.7742,85,35,50,35,2.8979,1.5935,120,1.3044,0.6214,15057071,15057095
0.5098,0.2823,1.7012,95,30,60,35,2.7846,1.4315,125,1.3531,0.6096,15057095,15057120
0.5245,0.2637,1.5721,95,60,60,35,2.7375,1.4196,155,1.3179,0.6103,15057120,15057151
0.524,0.2799,2.0841,70,90,45,25,3.1407,1.4359,160,1.7048,0.5833,15057151,15057183
0.5112,0.3152,1.8861,95,35,55,40,3.3666,1.6457,130,1.721,0.5847,15057183,15057209
0.5288,0.4178,1.7598,120,30,50,70,3.9504,1.4315,150,2.519,0.5981,15072013,15072043
0.4458,0.4636,1.6903,75,140,45,30,3.4036,2.0891,65,1.3144,0.5643,15072043,15072056
0.5168,0.362,1.82,75,35,45,30,2.8376,1.5174,110,1.3202,0.5779,15072056,15072078
0.4799,0.4183,1.7598,70,40,45,25,3.1269,1.4665,110,1.6605,0.573,15072078,15072100
0.4892,0.4322,1.82,75,35,50,25,3.1915,1.5006,110,1.6909,0.5763,15072100,15072122
0.4901,0.4521,1.8212,65,25,50,15,3.062,1.5614,90,1.5006,0.5882,15072122,15072140
0.4699,0.412,1.8951,75,35,50,25,3.3312,1.5006,110,1.8306,0.5765,15072140,15072162
0.5058,0.381,1.885,75,30,50,25,3.1266,1.5654,105,1.5611,0.5702,15072162,15072183
0.4917,0.3616,2.015,75,40,45,30,3.1114,1.5815,115,1.5299,0.5545,15072183,15072206
0.5133,0.347,1.7099,80,35,45,35,2.6712,1.4432,115,1.2279,0.5881,15080105,15080128
0.4036,0.3594,1.8246,130,60,90,40,4.0387,1.235,190,2.8037,0.577,15087048,15087086
0.4981,0.3948,2.0244,60,30,50,10,3.0041,1.6302,90,1.3739,0.5672,15087086,15087104
0.4899,0.4021,2.0244,90,50,50,40,3.6043,1.4964,140,2.1079,0.5573,15087104,15087132
0.4566,0.4006,1.9543,65,5,50,15,2.9928,1.7658,70,1.227,0.5585,15087132,15087146
0.5021,0.3106,1.6302,95,25,55,40,2.8511,1.5614,120,1.2897,0.5841,15095037,15095061
0.4801,0.3732,1.6912,80,50,50,30,3.1256,1.4315,130,1.6942,0.5916,15095061,15095087
0.5144,0.3674,1.5614,75,25,50,25,2.6805,1.5006,100,1.1798,0.6016,15095087,15095107
0.4793,0.3311,1.8212,90,60,60,30,3.255,1.3789,150,1.8761,0.5756,15095107,15095137
0.5,0.3305,1.8246,80,35,55,25,2.9928,1.56,115,1.4328,0.5751,15095137,15095160
0.4872,0.3021,1.69,90,35,50,40,2.8144,1.4964,125,1.318,0.5878,15095160,15095185
0.4891,0.3215,1.5815,105,30,50,55,3.0564,1.3712,135,1.6852,0.5954,15095185,15095212
0.5358,0.3783,1.6912,80,25,50,30,2.832,1.5614,105,1.2706,0.5956,15102016,15102037
0.4911,0.3461,1.9597,90,40,50,40,3.4512,1.5174,130,1.9338,0.5859,15102037,15102063
0.5308,0.4204,1.8861,75,15,40,35,3.1862,1.695,90,1.4913,0.5835,15102063,15102081
0.4733,0.3097,2.081,95,50,80,15,3.4578,1.6912,145,1.7666,0.5887,15102081,15102110
0.4539,0.3741,1.8385,80,5,60,20,3.0109,1.6367,85,1.3743,0.5756,15102110,15102127
0.5094,0.4141,1.695,60,35,40,20,2.8103,1.3665,95,1.4438,0.5894,15102127,15102146
0.4736,0.3372,2.08,70,45,45,25,3.0967,1.695,115,1.4017,0.562,15110054,15110077
0.4963,0.4128,1.9673,65,45,40,25,3.0376,1.4665,110,1.5711,0.5757,15110077,15110099
0.4896,0.4568,1.695,70,30,35,35,3.0564,1.5077,100,1.5487,0.5714,15110099,15110119
0.5189,0.4336,1.9511,60,45,40,20,3.134,1.4964,105,1.6376,0.5687,15110119,15110140
0.4363,0.4018,2.016,75,25,45,30,3.1323,1.6263,100,1.506,0.537,15110140,15110160
0.4882,0.3502,1.82,70,55,50,20,2.9321,1.3665,125,1.5656,0.5578,15110160,15110185
0.5025,0.2879,1.7099,100,40,60,40,2.7439,1.4315,140,1.3124,0.5708,15110185,15110213
0.5225,0.3756,1.69,80,20,50,30,2.8718,1.56,100,1.3118,0.5584,15117040,15117060
0.5358,0.3067,1.6912,75,40,45,30,2.6935,1.5006,115,1.1929,0.5739,15117060,15117083
0.489,0.398,1.8246,70,45,50,20,2.9365,1.4432,115,1.4933,0.5509,15117083,15117106
0.5339,0.3726,1.8246,60,50,45,15,2.8029,1.4359,110,1.367,0.5466,15117106,15117128
0.4763,0.3503,1.7598,80,40,55,25,3.0021,1.4964,120,1.5057,0.5548,15117128,15117152
0.5095,0.3568,1.6302,90,40,50,40,2.8328,1.43,130,1.4028,0.5672,15117152,15117178
0.4884,0.3683,1.6367,75,30,50,25,2.798,1.4432,105,1.3548,0.5498,15117178,15117199
0.4882,0.3274,1.8861,80,25,55,25,2.9321,1.7658,105,1.1663,0.547,15125035,15125056
0.5489,0.3831,2.211,65,60,45,20,3.3176,1.4315,125,1.8861,0.5451,15125056,15125081
0.503,0.3844,2.0317,75,45,45,30,3.272,1.4315,120,1.8405,0.5533,15125185,15125209
0.479,0.3675,1.8861,70,50,50,20,3.1213,1.5006,120,1.6207,0.533,15140048,15140072
0.5106,0.3903,1.82,75,30,55,20,3.066,1.495,105,1.571,0.5392,15140072,15140093
0.4506,0.3595,1.8861,60,30,45,15,2.7444,1.5654,90,1.179,0.5471,15140093,15140111
0.5192,0.3504,1.625,70,65,50,20,2.6559,1.2367,135,1.4192,0.5437,15140111,15140138
0.4669,0.3841,1.5654,75,45,55,20,2.8699,1.3789,120,1.4911,0.5436,15140138,15140162
0.5105,0.3952,1.695,75,45,50,25,2.8012,1.34,120,1.4612,0.5431,15140162,15140186
0.5069,0.3971,1.8212,70,35,45,25,2.9741,1.43,105,1.5441,0.5542,15140186,15140207
0.4861,0.5053,1.4964,70,10,50,20,2.8082,1.4315,80,1.3768,0.5809,15155022,15155038
0.4775,0.3937,1.4359,95,10,60,35,2.8065,1.365,105,1.4415,0.5735,15155038,15155059
0.5217,0.4513,1.6912,70,40,45,25,2.9928,1.34,110,1.6528,0.5749,15155059,15155081
0.5095,0.4783,1.8212,65,25,40,25,3.1917,1.5614,90,1.6304,0.5675,15155081,15155099
0.4794,0.4271,1.82,65,20,40,25,3.1214,1.6263,85,1.4951,0.5612,15155099,15155116
0.5016,0.4711,1.8212,65,20,50,15,3.0251,1.4964,85,1.5287,0.549,15155116,15155133
0.4903,0.4828,1.6367,75,10,55,20,3.0606,1.5174,85,1.5432,0.5662,15155133,15155150
0.482,0.5227,1.8246,60,20,40,20,3.1044,1.5006,80,1.6038,0.5791,15155150,15155166
0.5199,0.4914,1.4964,75,0,50,25,2.7616,1.4964,75,1.2652,0.5754,15155166,15155181
0.5106,0.4688,1.695,70,25,45,25,3.0578,1.4359,95,1.6219,0.5627,15155181,15155200
0.469,0.3642,1.9128,65,60,40,25,3.0991,1.4359,125,1.6632,0.5726,15163037,15163062
0.455,0.4534,1.721,65,25,45,20,3.0032,1.4534,90,1.5498,0.5899,15163062,15163080
0.5014,0.4549,1.5815,75,15,45,30,2.75,1.3665,90,1.3835,0.5785,15163080,15163098
0.4862,0.4217,1.7012,85,25,50,35,3.1012,1.3789,110,1.7223,0.5825,15163098,15163120
0.5529,0.4212,1.9028,75,25,45,30,3.2281,1.5077,100,1.7204,0.5595,15163120,15163140
0.5239,0.3644,1.8488,70,5,50,20,2.8963,1.7848,75,1.1115,0.5447,15163140,15163155
0.4544,0.2811,1.9028,70,55,50,20,2.8643,1.5174,125,1.3469,0.5479,15163155,15163180
0.4696,0.4069,1.7658,70,40,55,15,3.0734,1.3789,110,1.6946,0.5485,15170033,15170055
0.4846,0.3377,1.8246,65,60,45,20,2.8453,1.4432,125,1.4021,0.5504,15170055,15170080
0.5091,0.3014,1.69,80,40,50,30,2.7296,1.3789,120,1.3507,0.5608,15170080,15170104
0.487,0.3705,1.6572,70,25,45,25,2.6728,1.3895,95,1.2833,0.5862,15170104,15170123
0.4897,0.4024,1.7658,60,60,40,20,2.9323,1.3016,120,1.6307,0.5741,15170123,15170147
0.4815,0.42,1.7099,75,20,50,25,2.886,1.4359,95,1.4501,0.5711,15170147,15170166
0.5105,0.45,1.5299,75,10,50,25,2.6857,1.3895,85,1.2962,0.5832,15170166,15170183
0.4568,0.4402,1.56,70,25,45,25,2.7627,1.3712,95,1.3915,0.587,15170183,15170202
0.4891,0.3809,1.6912,75,40,45,30,2.9265,1.43,115,1.4965,0.5931,15178030,15178053
0.47,0.3871,1.5654,85,20,50,35,2.8207,1.4315,105,1.3893,0.5851,15178053,15178074
0.5381,0.3563,1.7562,75,45,45,30,2.9014,1.3257,120,1.5756,0.5613,15178074,15178098
0.5341,0.36,1.9543,60,45,45,15,2.9433,1.5614,105,1.382,0.5546,15178098,15178119
0.5311,0.3636,1.8895,75,50,45,30,3.0622,1.5721,125,1.4901,0.559,15178119,15178144
0.4842,0.3934,1.885,80,30,50,30,3.531,1.6263,110,1.9047,0.571,15178144,15178166
0.4995,0.4006,2.015,80,30,55,25,3.516,1.7099,110,1.8061,0.5702,15178166,15178188
0.5178,0.4196,2.0192,90,15,40,50,3.6423,1.7562,105,1.8861,0.5726,15178188,15178209
0.4905,0.2931,1.9128,70,60,50,20,2.7862,1.4032,130,1.383,0.5454,15193059,15193085
0.4911,0.2536,1.5006,95,40,60,35,2.4404,1.3665,135,1.0738,0.5438,15193085,15193112
0.5261,0.2212,1.695,95,90,60,35,2.6207,1.1985,185,1.4221,0.5358,15193112,15193149
0.4764,0.2945,1.721,70,50,55,15,2.6068,1.3789,120,1.228,0.5525,15193149,15193173
0.5384,0.2634,2.0192,70,75,50,20,2.5384,1.2418,145,1.2965,0.5702,15193173,15193202
0.489,0.3981,1.5654,90,35,50,40,2.9365,1.3016,125,1.6349,0.6004,15200045,15200070
0.4992,0.3838,1.5815,85,20,45,40,2.8674,1.4359,105,1.4315,0.6011,15200070,15200091
0.4776,0.3436,1.695,85,40,50,35,2.8615,1.4315,125,1.4301,0.6072,15200091,15200116
0.5106,0.3482,1.7012,95,35,50,45,3.0578,1.3665,130,1.6912,0.6091,15200116,15200142
0.5374,0.3478,1.8304,70,30,45,25,2.8239,1.5614,100,1.2626,0.592,15200142,15200162
0.4837,0.358,1.695,80,15,55,25,2.6912,1.5174,95,1.1737,0.5849,15200162,15200181
0.4799,0.3715,1.9028,70,60,55,15,3.1269,1.3016,130,1.8253,0.5785,15200181,15200207
0.4537,0.3073,1.7562,65,55,50,15,2.7368,1.5077,120,1.2292,0.6105,15208037,15208061
0.5228,0.303,1.625,70,95,40,30,2.738,1.2418,165,1.4961,0.6229,15208061,15208094
0.4782,0.4043,1.6912,70,35,45,25,2.8676,1.4315,105,1.4361,0.6307,15208094,15208115
0.4547,0.4025,1.5174,75,15,50,25,2.5732,1.3712,90,1.202,0.6243,15208115,15208133
0.447,0.472,1.6302,80,35,45,35,2.9408,1.17,115,1.7708,0.6224,15208133,15208156
0.4891,0.5149,1.4315,80,5,45,35,2.9509,1.3145,85,1.6364,0.6173,15208156,15208173
0.4602,0.5227,1.6263,70,10,40,30,3.0197,1.4432,80,1.5765,0.6284,15208173,15208189
0.4762,0.5002,1.4359,70,15,45,25,2.73,1.3895,85,1.3405,0.6227,15208189,15208206
0.4497,0.3934,1.5006,85,25,55,30,2.6015,1.1861,110,1.4153,0.6078,15215148,15215170
0.4658,0.3862,1.5006,90,40,60,30,2.8222,1.17,130,1.6522,0.6151,15215170,15215196
0.4647,0.3553,1.3712,85,20,65,20,2.5527,1.3145,105,1.2381,0.622,15215196,15215217
0.4712,0.3756,1.5006,85,35,55,30,2.773,1.3,120,1.473,0.5807,15223042,15223066
0.4864,0.3832,1.7742,80,35,50,30,2.8098,1.3065,115,1.5033,0.6058,15230032,15230055
0.4551,0.4151,1.4315,80,30,45,35,2.575,1.3,110,1.275,0.5846,15230147,15230169
0.4724,0.3544,1.5077,80,30,50,30,2.4917,1.1718,110,1.3199,0.5988,15230169,15230191
0.469,0.3737,1.3895,90,40,55,35,2.5558,1.1772,130,1.3786,0.617,15230191,15230217
0.4512,0.3183,1.3789,90,60,60,30,2.4871,1.072,150,1.4151,0.5831,15238052,15238082
0.4615,0.2954,1.5721,80,80,55,25,2.6799,1.1221,160,1.5579,0.5957,15238082,15238114
0.4494,0.341,1.56,85,50,50,35,2.6077,1.2367,135,1.371,0.6122,15238114,15238141
0.4361,0.3078,1.4964,80,45,50,30,2.5384,1.3016,125,1.2368,0.5815,15245040,15245065
0.4875,0.3155,1.5815,90,70,70,20,2.6665,1.1069,160,1.5596,0.5911,15245065,15245097
0.4612,0.2564,1.3572,80,40,65,15,2.4126,1.3,120,1.1126,0.5404,15245097,15245121
0.4254,0.3664,1.4032,85,75,50,35,2.6019,1.1126,160,1.4893,0.5929,15245121,15245153
0.5532,0.3687,1.8212,75,25,40,35,3.055,1.7658,100,1.2892,0.5757,16033112,16033132
0.5217,0.4164,1.7658,70,20,45,25,2.9928,1.69,90,1.3028,0.5778,16033132,16033150
0.5323,0.3286,1.7658,75,20,55,20,2.811,1.5614,95,1.2496,0.578,16033150,16033169
0.5252,0.3496,1.6367,75,40,45,30,2.8222,1.4964,115,1.3258,0.5978,16033169,16033192
0.5214,0.3793,1.6912,90,25,50,40,3.0154,1.4822,115,1.5331,0.5882,16033192,16033215
0.5659,0.3761,1.755,90,10,45,45,3.4475,1.9543,100,1.4932,0.5836,16048092,16048112
0.5185,0.3461,2.0841,85,25,50,35,3.51,1.8212,110,1.6888,0.5534,16048178,16048200
0.5179,0.4341,1.9597,80,30,60,20,3.5162,1.4964,110,2.0197,0.6262,16063042,16063064
0.4603,0.3805,2.146,60,25,30,30,3.2604,1.8212,85,1.4393,0.6213,16063064,16063081
0.5087,0.431,1.6912,75,25,40,35,3.069,1.5006,100,1.5684,0.6134,16063081,16063101
0.5237,0.4757,1.5614,70,20,60,10,3.0021,1.5614,90,1.4408,0.6126,16063101,16063119
0.5226,0.3238,2.081,65,60,50,15,3.008,1.5721,125,1.4359,0.5979,16071111,16071136
0.509,0.3038,2.0244,75,55,50,25,3.3202,1.5721,130,1.7481,0.594,16071136,16071162
0.5006,0.337,1.9028,75,30,55,20,3.1268,1.69,105,1.4368,0.6005,16071162,16071183
0.5299,0.3529,1.9543,70,50,45,25,3.1919,1.5654,120,1.6265,0.5878,16071183,16071207
0.6071,0.3795,1.9028,90,10,45,45,3.64,1.7658,100,1.8742,0.5399,16078164,16078184
0.5488,0.3733,1.9511,70,35,45,25,3.3164,1.7562,105,1.5602,0.5647,16101114,16101135
0.581,0.2949,2.1489,65,35,50,15,3.1642,1.82,100,1.3442,0.5684,16101135,16101155
0.5285,0.35,2.081,60,35,45,15,3.2187,1.8385,95,1.3802,0.5504,16101155,16101174
0.5451,0.3354,2.0244,60,30,50,10,2.8719,1.7012,90,1.1707,0.55,16101174,16101192
0.5299,0.43,1.9543,65,45,50,15,3.3212,1.5654,110,1.7558,0.5611,16101192,16101214
0.508,0.3654,1.9543,75,55,50,25,2.9541,1.43,130,1.5241,0.5814,16116091,16116117
0.5399,0.4586,1.495,80,40,45,35,3.2526,1.3065,120,1.9461,0.5736,16131041,16131065
0.5552,0.3737,1.5006,65,55,45,20,2.9266,1.3789,120,1.5478,0.5768,16131122,16131146
0.5465,0.3935,1.5614,70,25,50,20,2.7382,1.625,95,1.1132,0.5823,16131146,16131165
0.4766,0.3834,1.8861,65,45,40,25,2.8672,1.4964,110,1.3708,0.5893,16131165,16131187
0.4431,0.3956,1.5654,120,20,90,30,3.3868,1.3665,140,2.0202,0.6047,16131187,16131215
0.5121,0.4137,1.6367,75,30,50,25,2.9306,1.56,105,1.3706,0.5477,16139097,16139118
0.5304,0.3404,1.9511,75,45,50,25,3.0734,1.5006,120,1.5728,0.5431,16139118,16139142
0.5418,0.3275,1.8304,60,40,50,10,3.009,1.6302,100,1.3789,0.5248,16139142,16139162
0.5,0.3965,2.2338,55,65,40,15,3.39,1.6302,120,1.7598,0.5253,16146053,16146077
0.5113,0.3109,2.0841,85,20,50,35,3.0618,1.8246,105,1.2372,0.5289,16146118,16146139
0.5558,0.3308,1.8246,75,40,55,20,3.0764,1.5654,115,1.511,0.5545,16146139,16146162
0.4806,0.277,2.0891,80,60,55,25,3.0032,1.7099,140,1.2934,0.5466,16146162,16146190
0.4998,0.3247,1.6367,85,35,55,30,2.9914,1.4964,120,1.495,0.5524,16154097,16154121
0.5118,0.3626,1.7012,90,30,55,35,2.9321,1.495,120,1.4371,0.5493,16154121,16154145
0.5481,0.3714,2.0841,75,30,45,30,3.3206,1.6912,105,1.6294,0.5411,16161172,16161193
0.545,0.3022,2.0244,85,20,55,30,3.0032,1.82,105,1.1832,0.5294,16161193,16161214
0.5217,0.2923,1.9511,70,45,50,20,2.9928,1.5614,115,1.4315,0.569,16169042,16169065
0.5322,0.33,1.7562,85,30,60,25,2.9312,1.5614,115,1.3698,0.5606,16169065,16169088
0.5331,0.3108,1.8895,55,55,45,10,2.9265,1.56,110,1.3665,0.5556,16169088,16169110
0.5119,0.3912,1.7562,60,25,45,15,2.7965,1.56,85,1.2365,0.5566,16169110,16169127
0.5615,0.4622,1.8895,65,30,45,20,3.1447,1.4315,95,1.7132,0.5419,16169127,16169146
0.5455,0.3394,1.9597,60,50,45,15,2.7509,1.7658,110,0.9851,0.5317,16169146,16169168
0.5601,0.3406,1.9511,60,30,50,10,2.6183,1.5006,90,1.1176,0.55,16169168,16169186
0.5174,0.3696,1.9769,85,40,60,25,3.3917,1.56,125,1.8317,0.5437,16184130,16184155
0.479,0.3734,1.8385,75,20,50,25,3.1213,1.755,95,1.3663,0.5552,16184155,16184174
0.513,0.258,1.8304,95,55,55,40,2.9391,1.4359,150,1.5032,0.5783,16199081,16199111
0.4997,0.3863,1.7012,75,10,55,20,2.7315,1.69,85,1.0415,0.5217,16221102,16221119
0.4493,0.349,1.6367,70,55,50,20,2.8425,1.365,125,1.4775,0.5363,16221119,16221144
0.5098,0.3186,1.7562,70,65,45,25,2.7046,1.277,135,1.4276,0.5289,16221144,16221171
0.4763,0.3538,1.625,90,20,60,30,2.8788,1.3789,110,1.5,0.5506,16221171,16221193
0.4683,0.3877,1.755,65,40,55,10,2.5932,1.3712,105,1.222,0.5566,16221193,16221214
0.4881,0.3125,1.8861,80,70,50,30,3.3401,1.5006,150,1.8394,0.5594,16229163,16229193
0.4814,0.4129,1.8861,75,40,50,25,3.3864,1.6302,115,1.7562,0.5331,16229193,16229216
0.5322,0.2639,1.8861,80,65,55,25,2.698,1.5006,145,1.1973,0.5558,16237106,16237135
0.4796,0.2295,1.6263,110,45,60,50,2.8753,1.4359,155,1.4394,0.5595,16237135,16237166
0.5136,0.2913,1.5614,85,55,55,30,2.8098,1.3789,140,1.4309,0.5665,16237166,16237194
0.4796,0.294,1.8385,70,70,55,15,2.8753,1.3789,140,1.4964,0.565,16252087,16252115
0.4909,0.2779,2.145,80,80,50,30,3.2023,1.5614,160,1.641,0.5803,17018037,17018069
0.5766,0.32,2.015,65,55,50,15,3.1646,1.5721,120,1.5925,0.5703,17018069,17018093
0.5359,0.3578,2.2898,80,40,50,30,3.6411,1.8246,120,1.8164,0.5476,17018093,17018117
0.4895,0.2753,1.8246,75,50,50,25,2.8012,1.6457,125,1.1555,0.5737,17033129,17033154
0.4514,0.3384,1.5614,75,40,50,25,2.7356,1.3712,115,1.3645,0.6085,17033154,17033177
0.5351,0.3998,1.5306,80,155,55,25,3.0757,2.2252,60,0.8504,0.6009,17078039,17078051
0.4795,0.3891,1.9597,75,25,55,20,3.2563,1.6457,100,1.6107,0.5909,17078051,17078071
0.5109,0.3933,1.6457,75,20,45,30,2.9265,1.4534,95,1.473,0.5756,17086159,17086178
0.5455,0.35,1.9673,65,40,45,20,2.7509,1.495,105,1.2559,0.5788,17086178,17086199
0.5,0.368,1.8488,95,35,65,30,3.25,1.365,130,1.885,0.5893,17093073,17093099
0.5902,0.2093,1.3341,145,95,105,40,2.5427,1.625,110,0.9177,0.6104,17093099,17093121
0.5162,0.2972,1.7742,75,65,50,25,2.77,1.5006,140,1.2694,0.611,17093121,17093149
0.568,0.3991,1.7598,65,45,50,15,2.863,1.43,110,1.433,0.6023,17093149,17093171
0.5111,0.4383,1.6367,65,30,50,15,2.9279,1.6263,95,1.3016,0.5919,17093171,17093190
0.524,0.3171,2.1538,70,35,45,25,3.1407,1.8212,105,1.3195,0.5554,17101089,17101110
0.5612,0.351,1.6302,75,25,55,20,2.8182,1.6457,100,1.1726,0.5424,17101110,17101130
0.4997,0.4572,1.5614,70,25,45,25,2.8615,1.56,95,1.3015,0.5744,17108035,17108054
0.5094,0.4596,1.4964,80,25,55,25,2.8103,1.43,105,1.3803,0.5884,17108054,17108075
0.5358,0.4195,1.7099,75,20,45,30,3.0931,1.625,95,1.4681,0.551,17116165,17116184
0.4892,0.385,1.695,55,55,35,20,2.8027,1.5299,110,1.2727,0.5787,17123069,17123091
0.5008,0.357,1.69,75,40,50,25,2.8674,1.3712,115,1.4962,0.5436,17123091,17123114
0.4735,0.3907,1.7598,75,40,40,35,3.2311,1.4359,115,1.7952,0.5586,17123114,17123137
0.4784,0.3549,1.721,75,20,55,20,2.8662,1.5299,95,1.3363,0.5567,17123137,17123156
0.503,0.4257,1.9543,60,40,40,20,3.3624,1.5935,100,1.7689,0.5585,17146107,17146127
0.5187,0.4555,1.7658,65,20,40,25,3.1327,1.6912,85,1.4414,0.5595,17146127,17146144
0.5217,0.414,1.7978,65,15,40,25,2.9928,1.625,80,1.3678,0.5678,17146144,17146160
0.5416,0.4138,1.7742,85,20,45,40,3.1227,1.5614,105,1.5614,0.5841,17146160,17146181
0.5543,0.3844,1.7658,75,10,45,30,2.9315,1.6912,85,1.2402,0.5907,17146181,17146198
0.4854,0.392,1.755,75,15,50,25,2.9732,1.625,90,1.3482,0.5824,17146198,17146216
0.5193,0.3337,2.015,55,55,40,15,3.2567,1.721,110,1.5357,0.5277,17153033,17153055
0.5201,0.3005,1.9769,75,45,50,25,3.1269,1.6711,120,1.4558,0.5252,17153164,17153188
0.5122,0.2759,2.1695,65,55,55,10,2.9436,1.6263,120,1.3173,0.521,17153188,17153212
0.5648,0.3417,1.6263,75,40,55,20,2.6468,1.3,115,1.3468,0.5929,17168153,17168176
0.4846,0.4168,1.8385,65,45,45,20,2.82,1.4534,110,1.3665,0.5792,17199036,17199058
0.5137,0.3372,1.5614,80,30,60,20,2.5432,1.3665,110,1.1766,0.6013,17199058,17199080
0.568,0.3641,1.69,80,50,60,20,2.863,1.3065,130,1.5565,0.5864,17199080,17199106
0.529,0.3861,2.081,70,30,45,25,3.3379,1.6263,100,1.7116,0.5551,17199106,17199126
0.5828,0.4465,1.9597,65,25,45,20,3.3629,1.7658,90,1.5971,0.5462,17199126,17199144
0.5216,0.3777,1.8246,55,15,50,5,2.8662,1.9597,70,0.9065,0.5615,17199144,17199158
0.4824,0.3904,1.7658,65,50,35,30,2.833,1.3665,115,1.4665,0.5596,17206033,17206056
0.5236,0.3416,1.721,75,25,50,25,2.6068,1.3665,100,1.2403,0.5618,17206056,17206076
0.5485,0.3773,1.5077,85,40,45,40,2.8831,1.365,125,1.5181,0.5785,17206076,17206101
0.5506,0.3806,1.4964,65,25,50,15,2.6077,1.5815,90,1.0262,0.5825,17206101,17206119
0.534,0.3679,1.7099,80,55,55,25,3.0816,1.3895,135,1.692,0.5664,17236034,17236061
0.5041,0.3505,1.7658,80,30,50,30,2.8834,1.6457,110,1.2378,0.5634,17236061,17236083
0.5495,0.3498,1.695,80,45,45,35,2.9,1.4534,125,1.4465,0.5628,17236083,17236108
0.4894,0.4342,1.8212,65,35,45,20,3.0578,1.4432,100,1.6145,0.6365,17236199,17236219
0.5342,0.3321,1.7658,80,55,50,30,2.9304,1.2418,135,1.6886,0.6231,17244152,17244179
0.5374,0.3033,1.8304,80,30,60,20,2.8239,1.5654,110,1.2585,0.6293,17244179,17244201
0.4744,0.3838,1.7012,95,30,60,35,3.2998,1.4315,125,1.8683,0.5568,19003188,19003213
0.5072,0.2867,2.2252,80,75,45,35,3.4697,1.5815,155,1.8882,0.5671,19011156,19011187
0.497,0.3322,1.8895,70,20,45,25,2.8893,1.7598,90,1.1295,0.5556,19011187,19011205
0.5087,0.3671,1.9543,65,40,45,20,3.069,1.495,105,1.574,0.5672,19018091,19018112
0.446,0.4209,1.9543,80,40,45,35,3.5005,1.5614,120,1.9391,0.5836,19018112,19018136
0.4766,0.4132,1.7012,80,25,45,35,3.0036,1.5614,105,1.4423,0.585,19018136,19018157
0.4882,0.4197,1.69,75,25,50,25,2.9321,1.4315,100,1.5006,0.6013,19018157,19018177
0.4576,0.4648,1.495,80,20,50,30,2.9962,1.4315,100,1.5647,0.5821,19018177,19018197
0.4702,0.4351,1.5654,75,25,50,25,2.9549,1.3895,100,1.5654,0.5804,19033028,19033048
0.4578,0.3598,1.4432,90,25,60,30,2.7571,1.3895,115,1.3675,0.5699,19033048,19033071
0.4554,0.3451,1.5721,80,45,50,30,2.7453,1.2621,125,1.4832,0.5637,19033071,19033096
0.5095,0.3899,1.7344,75,45,50,25,2.8328,1.2503,120,1.5825,0.5566,19033096,19033120
0.4963,0.4176,1.4315,80,20,50,30,2.6322,1.4315,100,1.2008,0.5863,19041103,19041123
0.4878,0.4901,1.3016,80,20,55,25,2.6682,1.3065,100,1.3617,0.5601,19041123,19041143
0.5054,0.3943,1.3065,100,25,60,40,2.8092,1.3016,125,1.5075,0.5479,19041143,19041168
0.4738,0.4728,1.5077,75,30,45,30,2.884,1.4196,105,1.4644,0.5187,19041168,19041189
0.4858,0.3569,1.56,80,25,55,25,2.5564,1.3665,105,1.1898,0.5288,19041189,19041210
0.4837,0.4026,1.6302,75,15,45,30,2.7177,1.5006,90,1.2171,0.574,19048091,19048109
0.4955,0.37,1.5654,95,20,50,45,2.7545,1.3145,115,1.44,0.5938,19048109,19048132
0.4647,0.3387,1.5654,85,30,45,40,2.5527,1.365,115,1.1877,0.5814,19048132,19048155
0.4551,0.3131,1.5721,85,50,55,30,2.575,1.1861,135,1.3888,0.5686,19048155,19048182
0.5006,0.4456,1.7848,70,30,45,25,3.1268,1.3895,100,1.7372,0.5807,19064061,19064081
0.4691,0.4923,1.8212,55,25,35,20,3.0609,1.5654,80,1.4955,0.5929,19064081,19064097
0.4955,0.4609,1.6572,60,20,50,10,2.577,1.4359,80,1.1412,0.5532,19064097,19064113
0.4539,0.4529,1.7658,70,35,50,20,2.8961,1.277,105,1.619,0.5462,19064113,19064134
0.5346,0.4286,1.495,75,30,50,25,2.8071,1.3145,105,1.4926,0.5788,19064134,19064155
0.4798,0.3526,1.7658,75,35,45,30,2.8739,1.5006,110,1.3732,0.5483,19064155,19064177
0.5214,0.4393,1.7012,80,15,50,30,3.0154,1.3789,95,1.6365,0.5554,19064177,19064196
0.4869,0.449,1.8304,70,25,45,25,3.0822,1.5721,95,1.51,0.5233,19064196,19064215
0.4788,0.2892,1.7742,85,30,55,30,2.769,1.5654,115,1.2036,0.6034,19086119,19086142
0.5005,0.3223,1.6912,75,55,50,25,2.8747,1.3257,130,1.549,0.5903,19086142,19086168
0.4751,0.415,1.9128,65,55,40,25,3.2199,1.4388,120,1.7811,0.5892,19086168,19086192
0.6054,0.2911,2.2787,55,65,40,15,3.037,1.721,120,1.3161,0.5274,19101021,19101045
0.5016,0.3496,2.015,75,35,50,25,3.263,1.5614,110,1.7016,0.5592,19101164,19101186
0.5248,0.2943,1.7742,80,10,60,20,2.613,1.6367,90,0.9763,0.555,19101186,19101204
0.477,0.4117,1.9543,70,25,50,20,3.1463,1.625,95,1.5213,0.5874,19109033,19109052
0.5208,0.4099,1.9128,70,30,45,25,3.1227,1.5006,100,1.6221,0.5552,19109052,19109072
0.4691,0.3167,1.8212,65,35,50,15,2.8264,1.6263,100,1.2001,0.5336,19109072,19109092
0.489,0.4105,1.8212,65,40,50,15,2.9365,1.3257,105,1.6108,0.5615,19109092,19109113
0.5,0.4128,1.6912,65,45,45,20,2.86,1.365,110,1.495,0.5804,19109178,19109200
0.5654,0.4714,1.7562,65,20,40,25,2.8766,1.56,85,1.3166,0.5371,19116024,19116041
0.4998,0.3512,1.9673,70,25,50,20,2.9914,1.6263,95,1.3651,0.5333,19116041,19116060
0.5126,0.3583,2.0317,70,50,45,25,3.0671,1.495,120,1.5721,0.5513,19116060,19116084
0.5121,0.3306,1.755,80,30,50,30,2.9306,1.5721,110,1.3585,0.5538,19116084,19116106
0.5335,0.3315,1.5614,85,25,55,30,2.6803,1.5006,110,1.1797,0.5636,19116106,19116128
0.4678,0.4112,1.7562,55,50,40,15,2.9312,1.43,105,1.5012,0.5557,19116128,19116149
0.5455,0.4149,1.7658,65,40,45,20,3.0168,1.3712,105,1.6457,0.5533,19116149,19116170
0.5346,0.4004,1.7658,65,20,45,20,2.8071,1.6457,85,1.1615,0.5532,19116170,19116187
0.4862,0.4278,1.695,70,30,45,25,2.9533,1.5006,100,1.4527,0.5619,19116187,19116207
0.4837,0.4697,1.3,80,30,50,30,2.7177,1.1772,110,1.5405,0.5883,19124038,19124060
0.4767,0.4423,1.17,95,15,55,40,2.7578,1.3145,110,1.4432,0.5742,19124060,19124082
0.5097,0.4512,1.5614,65,45,45,20,2.6811,1.3145,110,1.3665,0.5544,19124082,19124104
0.4513,0.342,1.695,75,20,55,20,2.6087,1.3665,95,1.2421,0.5463,19124104,19124123
0.4517,0.4134,1.4315,80,50,50,30,2.7495,1.1772,130,1.5723,0.5572,19124123,19124149
0.4645,0.4566,1.5654,70,40,45,25,2.8023,1.2418,110,1.5604,0.5534,19124149,19124171
0.5362,0.3772,1.4964,75,35,50,25,2.6667,1.3016,110,1.3651,0.5429,19124171,19124193
0.5429,0.3862,1.755,65,40,45,20,2.8759,1.43,105,1.4459,0.53,19124193,19124214
0.456,0.3435,1.8246,75,55,55,20,2.9967,1.43,130,1.5667,0.5297,19139045,19139071
0.5245,0.4239,1.9543,70,55,50,20,2.8742,1.3665,125,1.5077,0.5038,19139071,19139096
0.4994,0.348,2.016,60,60,50,10,3.1268,1.5077,120,1.6191,0.4906,19139096,19139120
0.5059,0.4006,2.0244,65,45,50,15,2.9997,1.5614,110,1.4383,0.5062,19139120,19139142
0.5103,0.3268,1.8861,70,45,50,20,2.9323,1.5174,115,1.4149,0.5379,19139142,19139165
0.4984,0.4277,2.0244,65,40,45,20,3.0251,1.4964,105,1.5287,0.5388,19139165,19139186
0.4771,0.3809,1.69,95,25,50,45,3.2699,1.5077,120,1.7622,0.5331,19139186,19139210
0.469,0.4626,1.5077,65,30,50,15,2.8574,1.4665,95,1.391,0.5608,19146189,19146208
0.5294,0.3581,1.8246,80,40,50,30,3.3176,1.56,120,1.7576,0.5538,19154028,19154052
0.4985,0.3953,1.3004,95,85,60,35,2.621,1.7562,60,0.8648,0.5652,19154052,19154064
0.5092,0.4303,1.56,80,30,50,30,2.9611,1.3065,110,1.6546,0.5448,19154064,19154086
0.5312,0.4013,1.8304,75,35,45,30,3.069,1.5077,110,1.5614,0.5265,19154086,19154108
0.4983,0.4003,2.145,65,65,45,20,3.1335,1.3257,130,1.8077,0.5211,19154185,19154211
0.4569,0.4001,1.8212,75,45,40,35,3.0014,1.3789,120,1.6225,0.5359,19161030,19161054
0.5116,0.4377,1.695,60,35,40,20,2.798,1.3712,95,1.4268,0.5384,19161054,19161073
0.4783,0.4733,1.755,60,35,40,20,2.9928,1.4315,95,1.5614,0.5338,19161073,19161092
0.4571,0.4312,1.8385,65,35,40,25,2.8759,1.4315,100,1.4444,0.5138,19161092,19161112
0.4791,0.4428,1.7658,70,40,50,20,2.9973,1.3145,110,1.6827,0.5171,19161112,19161134
0.4773,0.4276,1.6263,70,25,50,20,2.863,1.4359,95,1.4271,0.5074,19161134,19161153
0.4626,0.4279,1.5614,75,25,50,25,2.8239,1.3665,100,1.4574,0.5218,19161153,19161173
0.4763,0.3917,1.6263,75,45,45,30,2.8788,1.3065,120,1.5724,0.5342,19161173,19161197
0.4182,0.4126,1.5614,70,30,50,20,2.802,1.3712,100,1.4308,0.5259,19161197,19161217
0.5,0.4253,1.3665,90,35,55,35,2.8718,1.17,125,1.7018,0.5875,19169027,19169052
0.5011,0.3782,1.495,65,20,50,15,2.349,1.4359,85,0.9131,0.5854,19169052,19169069
0.4534,0.4044,1.495,70,55,45,25,2.6161,1.1772,125,1.4389,0.5913,19169069,19169094
0.5214,0.4819,1.4432,65,15,45,20,2.3719,1.1861,80,1.1857,0.5633,19169094,19169110
0.4613,0.3863,1.5654,65,50,45,20,2.5365,1.2367,115,1.2998,0.5781,19169110,19169133
0.5054,0.3982,1.495,65,55,50,15,2.4971,1.17,120,1.3271,0.5796,19169133,19169157
0.479,0.4016,1.5614,70,40,45,25,2.7445,1.2621,110,1.4825,0.5786,19169157,19169179
0.4609,0.3638,1.365,90,25,60,30,2.4142,1.3145,115,1.0997,0.5979,19169179,19169202
0.5137,0.2707,1.695,85,65,50,35,2.5432,1.3065,150,1.2367,0.5482,19176030,19176060
0.5346,0.3276,1.7012,80,60,55,25,2.7966,1.3065,140,1.4901,0.5653,19176060,19176088
0.4773,0.3529,1.8895,70,45,45,25,2.863,1.495,115,1.368,0.5509,19176088,19176111
0.5185,0.4136,1.6367,70,40,45,25,2.886,1.3665,110,1.5194,0.5585,19176111,19176133
0.5154,0.416,1.625,70,10,55,15,2.696,1.4964,80,1.1996,0.5656,19176133,19176149
0.4899,0.2884,1.56,80,30,65,15,2.4211,1.3895,110,1.0316,0.5641,19176149,19176171
0.541,0.324,1.7562,80,30,50,30,2.6458,1.4359,110,1.2099,0.5121,19191027,19191049
0.5223,0.3289,1.8304,75,50,55,20,2.9969,1.4359,125,1.561,0.5189,19191158,19191183
0.5153,0.3127,1.8951,65,50,45,20,2.9688,1.5654,115,1.4033,0.5454,19191183,19191206
0.4822,0.4293,1.4964,70,15,50,20,2.6482,1.3712,85,1.277,0.5825,19199117,19199134
0.4554,0.3822,1.7562,70,65,45,25,2.8867,1.277,135,1.6096,0.5809,19199134,19199161
0.4892,0.4016,1.82,70,45,45,25,2.9709,1.3145,115,1.6563,0.5545,19199161,19199184
0.4885,0.364,1.8895,65,35,45,20,2.8071,1.4534,100,1.3536,0.5361,19199184,19199204
0.5135,0.3593,1.7562,70,30,50,20,2.856,1.495,100,1.361,0.57,19206032,19206052
0.5245,0.3987,1.69,65,45,45,20,2.7375,1.4665,110,1.2711,0.5438,19206052,19206074
0.5043,0.3662,1.755,70,55,45,25,2.9899,1.4359,125,1.554,0.5479,19206074,19206099
0.4602,0.375,1.9511,60,55,40,20,3.0197,1.5077,115,1.5121,0.5628,19206099,19206122
0.5101,0.3787,1.695,80,25,50,30,2.9309,1.3895,105,1.5414,0.5837,19206122,19206143
0.557,0.3837,1.82,70,30,50,20,2.8032,1.495,100,1.3082,0.5847,19206143,19206163
0.4889,0.3878,1.8246,65,30,50,15,2.9279,1.5614,95,1.3665,0.5616,19206163,19206182
0.5,0.4182,1.8951,70,35,55,15,3.1308,1.4315,105,1.6993,0.5922,19206182,19206203
0.5,0.3673,1.6263,65,40,55,10,2.6,1.365,105,1.235,0.5121,19214030,19214051
0.4383,0.402,1.6912,75,45,50,25,2.9137,1.3,120,1.6137,0.5359,19214051,19214075
0.5,0.4155,1.69,70,45,45,25,2.863,1.277,115,1.5859,0.5486,19214075,19214098
0.4472,0.4404,1.695,70,25,45,25,2.9395,1.4315,95,1.5081,0.5664,19214098,19214117
0.4858,0.4144,1.56,70,30,50,20,2.5564,1.3145,100,1.2418,0.5669,19214117,19214137
0.5,0.3783,1.625,65,50,50,15,2.7331,1.2418,115,1.4913,0.5749,19214137,19214160
0.4649,0.4158,1.7598,65,35,50,15,2.7964,1.3665,100,1.4299,0.5692,19214160,19214180
0.4669,0.4147,1.6263,80,30,55,25,2.8152,1.3,110,1.5152,0.5793,19214180,19214202
0.4983,0.3027,1.755,95,85,50,45,3.3028,1.3665,180,1.9363,0.519,19244035,19244071
0.5455,0.3625,1.7562,70,30,50,20,2.86,1.6457,100,1.2143,0.517,19244071,19244091
0.4875,0.3658,1.8212,65,60,45,20,2.9607,1.4315,125,1.5292,0.5524,19252030,19252055
0.4878,0.3599,1.7598,85,25,50,35,2.9436,1.495,110,1.4486,0.5792,20040141,20040163
0.5237,0.3321,1.7598,90,40,55,35,2.8788,1.4359,130,1.4429,0.5858,20040163,20040189
0.5249,0.5083,1.43,75,25,50,25,2.7497,1.2367,100,1.513,0.5824,20070110,20070130
0.4752,0.4521,1.4964,70,35,45,25,2.613,1.3065,105,1.3065,0.5692,20070194,20070215
0.4776,0.3585,1.5614,95,50,55,40,2.8615,1.2143,145,1.6472,0.6021,20115129,20115158
0.4739,0.3394,1.4432,95,20,65,30,2.6207,1.3665,115,1.2541,0.5879,20115158,20115181
0.5,0.3809,1.8861,60,70,45,15,3.0153,1.2418,130,1.7735,0.5696,20115181,20115207
0.5241,0.3392,1.5614,90,45,50,40,2.7315,1.2503,135,1.4812,0.5918,20146026,20146053
0.4527,0.3365,1.43,90,30,55,35,2.7317,1.4315,120,1.3002,0.5793,20146053,20146077
0.5362,0.2958,1.7012,80,60,55,25,2.6667,1.2367,140,1.43,0.5644,20146077,20146105
0.4856,0.3638,1.4964,85,45,65,20,2.6805,1.43,130,1.2505,0.5677,20146105,20146131
0.5119,0.3786,1.69,80,40,55,25,2.6934,1.3016,120,1.3918,0.5596,20146131,20146155
0.5448,0.3823,1.695,65,45,50,15,2.7467,1.3789,110,1.3679,0.5679,20146155,20146177
0.5454,0.3249,1.8304,75,45,50,25,2.863,1.4964,120,1.3666,0.5752,20146177,20146201
0.5441,0.3925,1.82,70,40,50,20,3.0078,1.5721,110,1.4357,0.5262,20153125,20153147
0.4909,0.3967,1.755,90,10,60,30,3.2023,1.6367,100,1.5657,0.5306,20153147,20153167
0.5479,0.3445,1.82,75,20,55,20,2.7314,1.5721,95,1.1593,0.5205,20153167,20153186
0.5008,0.3696,1.6263,75,40,45,30,2.8674,1.4964,115,1.371,0.5203,20153186,20153209
0.5258,0.3623,1.7658,70,20,50,20,2.6079,1.5721,90,1.0357,0.5859,20161028,20161046
0.4755,0.4099,1.6302,75,25,50,25,2.7375,1.3145,100,1.423,0.5168,20168155,20168175
0.5012,0.4967,1.365,65,35,45,20,2.6065,1.2367,100,1.3698,0.5678,20183129,20183149
0.4878,0.4972,1.56,65,30,40,25,2.665,1.3065,95,1.3585,0.5725,20183149,20183168
0.4742,0.4523,1.3016,75,25,50,25,2.6079,1.3,100,1.3079,0.5684,20183168,20183188
0.5003,0.4069,1.3789,70,35,55,15,2.4717,1.2367,105,1.235,0.5719,20183188,20183209
0.5272,0.4346,1.56,75,15,60,15,2.6156,1.365,90,1.2506,0.5637,20191194,20191212
0.4841,0.3777,1.6302,75,40,60,15,2.9658,1.5077,115,1.4582,0.5536,20206102,20206125
0.5248,0.411,1.625,65,30,55,10,2.7359,1.4359,95,1.3,0.5479,20206125,20206144
0.5245,0.3875,1.8861,60,40,50,10,2.7375,1.4359,100,1.3016,0.55,20206144,20206164
0.5311,0.367,1.7742,70,40,45,25,3.0622,1.4359,110,1.6263,0.5407,20206164,20206186
0.4792,0.407,1.625,85,20,55,30,3.1227,1.4964,105,1.6263,0.5548,20221197,20221218
0.4781,0.3319,1.6912,75,50,45,30,2.6153,1.3065,125,1.3088,0.5361,20243099,20243124
0.551,0.2551,1.8895,80,70,55,25,2.6059,1.365,150,1.2409,0.5832,20251094,20251124
0.5483,0.2855,1.7658,75,60,40,35,2.9663,1.6302,135,1.3361,0.6288,21100108,21100135
0.5587,0.3183,1.95,70,35,50,20,2.814,1.6263,105,1.1877,0.6204,21100135,21100156
0.5207,0.3356,2.2186,70,25,40,30,3.1308,1.82,95,1.3108,0.6209,21115116,21115135
0.5135,0.2993,1.8304,75,45,50,25,2.6853,1.34,120,1.3453,0.6183,21138144,21138168
0.5547,0.2781,1.6263,110,30,55,55,2.4858,1.3789,140,1.1069,0.6283,21138168,21138196
0.492,0.4318,1.7658,65,25,35,30,2.9541,1.4665,90,1.4876,0.5858,21145137,21145155
0.5234,0.4029,1.82,70,30,50,20,2.8672,1.4315,100,1.4357,0.5699,21183170,21183190
0.4933,0.4132,1.5614,85,15,50,35,2.9255,1.5006,100,1.4248,0.5875,21190140,21190160
0.5118,0.4671,1.7099,65,40,40,25,2.9321,1.4432,105,1.4889,0.5887,21190160,21190181
0.5119,0.4357,1.7012,65,30,40,25,2.6934,1.5006,95,1.1928,0.5791,21190181,21190200
0.5249,0.4034,1.8304,70,20,45,25,3.013,1.6263,90,1.3867,0.5824,21198088,21198106
0.4894,0.3959,1.6302,75,40,45,30,3.0578,1.3789,115,1.6789,0.6014,21205076,21205099
0.5342,0.4505,1.6263,75,15,50,25,2.9304,1.4964,90,1.434,0.5763,21205189,21205207
0.5267,0.3322,1.6457,95,35,50,45,2.9645,1.4964,130,1.4681,0.6136,21213146,21213172
0.4886,0.3405,1.885,65,40,45,20,2.8221,1.5614,105,1.2607,0.5966,21213172,21213193
0.5071,0.3165,1.8861,70,45,55,15,2.7189,1.3789,115,1.34,0.5916,21213193,21213216
0.4755,0.3364,1.69,85,50,65,20,2.7375,1.4032,135,1.3344,0.6236,21220130,21220157
0.4954,0.314,1.4964,100,25,60,40,2.6274,1.3016,125,1.3257,0.6328,21220157,21220182
0.4752,0.4043,1.5614,70,40,45,25,2.7359,1.3016,110,1.4343,0.6301,21220182,21220204
0.4792,0.3874,1.6263,90,45,60,30,3.12,1.365,135,1.755,0.5595,21228034,21228061
0.5003,0.3986,1.69,75,25,45,30,2.8615,1.495,100,1.3665,0.5647,21228061,21228081
0.5202,0.4111,1.6302,70,50,45,25,2.8739,1.3065,120,1.5674,0.5959,22025041,22025065
0.5304,0.3694,1.82,75,30,55,20,3.0734,1.6302,105,1.4432,0.5731,22063081,22063102
0.5331,0.3573,1.885,70,35,50,20,2.9265,1.6302,105,1.2964,0.5584,22063102,22063123
0.5109,0.3991,1.7598,80,30,45,35,3.0564,1.56,110,1.4964,0.55,22063123,22063145
0.5108,0.4469,1.885,70,35,45,25,3.1915,1.5614,105,1.6302,0.5465,22063145,22063166
0.523,0.4184,1.82,70,15,45,25,3.1463,1.6302,85,1.5161,0.5413,22063166,22063183
0.5189,0.358,1.755,65,25,45,20,2.7557,1.6457,90,1.1101,0.5531,22063183,22063201
0.5554,0.3252,1.8895,85,20,50,35,2.9279,1.5721,105,1.3558,0.5971,22070009,22070030
0.5097,0.4036,1.8212,75,25,50,25,3.0606,1.6263,100,1.4343,0.6,22070030,22070050
0.5106,0.3928,1.9543,70,40,50,20,3.0578,1.56,110,1.4978,0.5907,22070050,22070072
0.5122,0.342,1.69,80,35,55,25,2.9436,1.5614,115,1.3822,0.5792,22070072,22070095
0.5098,0.3511,1.7562,75,35,45,30,2.9439,1.5077,110,1.4362,0.5755,22070095,22070117
0.5179,0.3304,1.95,80,50,45,35,3.1476,1.5006,130,1.647,0.5603,22070117,22070143
0.5058,0.3104,2.0192,80,45,45,35,2.9671,1.6302,125,1.3369,0.5592,22070143,22070168
0.478,0.2871,2.015,80,45,55,25,2.9914,1.5006,125,1.4907,0.5545,22070168,22070193
0.4903,0.37,2.211,75,35,45,30,3.3379,1.5174,110,1.8204,0.6099,22115025,22115047
0.5111,0.3489,1.9673,75,35,50,25,3.2021,1.6367,110,1.5654,0.5883,22115047,22115069
0.5109,0.3623,1.7012,80,35,50,30,2.9265,1.6367,115,1.2898,0.5993,22115069,22115092
0.4698,0.3348,1.9028,75,45,45,30,3.1825,1.495,120,1.6875,0.5798,22115092,22115116
0.549,0.3748,2.0244,80,60,45,35,3.315,1.495,140,1.82,0.5835,22115116,22115144
0.5613,0.3074,1.8895,125,20,50,75,3.7073,1.82,145,1.8873,0.5932,22115144,22115173
0.5335,0.3316,1.9828,120,140,45,75,3.785,2.081,115,1.704,0.5724,22115173,22115196
0.5145,0.4121,2.0192,80,0,40,40,3.4134,2.0192,80,1.3942,0.5861,22115196,22115212
0.5226,0.3616,1.8895,75,50,50,25,3.008,1.43,125,1.578,0.5365,22228041,22228066
0.5,0.2667,1.8304,90,55,55,35,3.0349,1.5721,145,1.4627,0.529,22228066,22228095
0.5083,0.24,1.9597,80,80,50,30,3.1114,1.5174,160,1.594,0.535,22228095,22228127
0.5258,0.3692,1.8304,60,40,45,15,2.7449,1.4359,100,1.309,0.5617,22236050,22236070
0.5197,0.3758,1.69,85,35,50,35,3.0046,1.4432,120,1.5614,0.5711,22236070,22236094
0.5096,0.382,1.9543,90,45,50,40,3.4462,1.5614,135,1.8848,0.5607,22236094,22236121
0.4537,0.3828,2.016,60,20,45,15,3.0122,1.7562,80,1.256,0.5645,22236121,22236137
0.4774,0.3663,1.8246,75,40,50,25,3.008,1.3665,115,1.6415,0.5678,22236137,22236160
0.4759,0.4086,1.755,70,40,50,20,3.0174,1.4359,110,1.5815,0.5675,22236160,22236182
0.5226,0.3715,2.0192,65,25,50,15,2.9954,1.695,90,1.3004,0.5992,22243121,22243139
0.491,0.3053,1.8861,115,45,85,30,3.5962,1.5654,160,2.0308,0.6263,22243139,22243171
0.4719,0.3507,1.7012,85,10,60,25,3.1952,1.7658,95,1.4294,0.6222,22243171,22243190
0.461,0.3472,1.8951,75,55,55,20,3.2916,1.5077,130,1.7839,0.6417,22243190,22243216
0.4635,0.3019,1.7658,80,55,50,30,2.6682,1.3016,135,1.3666,0.6093,23010144,23010171
0.4501,0.3288,1.5654,85,40,50,35,2.6033,1.2367,125,1.3666,0.6191,23010171,23010196
0.5375,0.3599,1.5654,90,40,45,45,2.6851,1.4359,130,1.2492,0.5453,23070116,23070142
0.4779,0.3645,1.695,90,50,50,40,3.2753,1.3,140,1.9753,0.5526,23108075,23108103
0.4994,0.3535,1.755,75,60,50,25,3.2565,1.5654,135,1.6911,0.5363,23108103,23108130
0.4782,0.4602,1.695,60,30,45,15,2.8676,1.5077,90,1.3599,0.5257,23123076,23123094
0.4534,0.5784,1.4964,65,30,50,15,3.0107,1.3712,95,1.6395,0.5296,23123094,23123113
0.5003,0.3821,1.625,70,40,45,25,2.6016,1.3145,110,1.2871,0.5068,23123197,23123219
0.4267,0.4371,1.3016,90,10,55,35,2.6076,1.2367,100,1.3709,0.5805,23130027,23130047
0.4515,0.49,1.365,80,10,50,30,2.8831,1.4359,90,1.4472,0.5595,23138036,23138054
0.4687,0.5319,1.4359,75,35,50,25,3.2019,1.3016,110,1.9002,0.5548,23138054,23138076
0.5441,0.3235,2.0841,55,80,45,10,3.0078,1.3665,135,1.6413,0.5191,23145046,23145073
0.478,0.3046,1.6302,90,20,55,35,2.9914,1.4964,110,1.4949,0.5084,23175044,23175066
0.4779,0.3671,1.6263,65,45,45,20,2.7504,1.43,110,1.3204,0.5015,23175066,23175088
0.5244,0.5149,1.04,85,15,55,30,2.6292,1.3145,100,1.3146,0.5146,23175088,23175108
0.5424,0.2777,1.56,90,30,60,30,2.5168,1.495,120,1.0218,0.5276,23236032,23236056
0.5858,0.3123,1.625,70,75,55,15,2.6723,1.365,145,1.3073,0.5419,23236056,23236085
0.489,0.3491,1.7658,65,40,45,20,2.6715,1.5654,105,1.1061,0.541,23236085,23236106
0.5482,0.3816,1.7562,60,40,45,15,2.7374,1.56,100,1.1774,0.4877,23243049,23243069
0.5132,0.347,1.8895,70,35,50,20,2.8323,1.6367,105,1.1956,0.5023,23251077,23251098
0.4874,0.4516,1.7562,75,20,50,25,3.0671,1.4964,95,1.5707,0.551,24010174,24010193
0.5317,0.3851,1.7562,80,30,50,30,3.0661,1.495,110,1.5711,0.5353,24010193,24010215
0.508,0.4146,1.5614,80,45,50,30,2.9541,1.3016,125,1.6525,0.5869,24018138,24018163
0.5179,0.391,2.015,75,25,50,25,3.1476,1.69,100,1.4576,0.5812,24070103,24070123
0.4766,0.3493,1.755,85,20,55,30,3.0036,1.6302,105,1.3734,0.5619,24070123,24070144
0.5207,0.3718,1.95,65,60,45,20,2.9959,1.4964,125,1.4995,0.573,24078087,24078112
0.5296,0.3928,2.5383,45,80,35,10,3.3162,1.56,125,1.7562,0.5599,24078112,24078137
0.5225,0.3843,2.08,60,35,40,20,2.8718,1.7562,95,1.1156,0.5431,24078137,24078156
0.4985,0.3621,1.8212,80,30,65,15,3.1537,1.5006,110,1.653,0.5439,24078156,24078178
0.5223,0.3726,1.885,65,50,45,20,2.9969,1.5721,115,1.4247,0.5518,24078178,24078201
0.5126,0.393,1.9511,65,40,40,25,3.0671,1.5654,105,1.5017,0.5874,24093031,24093052
0.5324,0.3459,1.9543,75,30,45,30,2.9325,1.5721,105,1.3604,0.5833,24093052,24093073
0.5308,0.2977,1.7598,85,30,50,35,2.9617,1.5614,115,1.4003,0.5887,24093073,24093096
0.5324,0.3062,2.0841,70,45,45,25,2.9325,1.5721,115,1.3604,0.5644,24093096,24093119
0.5103,0.3623,1.9543,60,40,40,20,2.9323,1.5614,100,1.371,0.5658,24093119,24093139
0.5094,0.3482,1.7598,70,35,45,25,2.8103,1.4964,105,1.3139,0.5829,24093139,24093160
0.4747,0.4849,2.0891,55,45,40,15,3.4668,1.4315,100,2.0354,0.5593,24100055,24100075
0.5192,0.4483,2.0841,65,35,45,20,3.38,1.6457,100,1.7343,0.5393,24100075,24100095
0.5277,0.368,2.2787,65,40,45,20,3.3283,1.755,105,1.5733,0.5499,24100095,24100116
0.5215,0.3385,2.0244,70,30,55,15,2.9915,1.7562,100,1.2353,0.5491,24100116,24100136
0.5181,0.3747,2.145,55,55,40,15,3.2621,1.56,110,1.7021,0.5483,24100136,24100158
0.5394,0.3803,2.016,80,20,40,40,3.2735,1.69,100,1.5835,0.5421,24100158,24100178
0.4704,0.3243,2.0841,75,25,50,25,3.0901,1.7658,100,1.3243,0.5319,24100178,24100198
0.485,0.3732,1.9511,75,25,45,30,3.0941,1.4534,100,1.6407,0.5434,24100198,24100218
0.5198,0.382,1.755,90,40,50,40,3.2514,1.4359,130,1.8155,0.5774,24131032,24131058
0.4915,0.4374,1.8304,70,25,45,25,3.0677,1.69,95,1.3777,0.568,24131058,24131077
0.4793,0.4119,1.7562,65,40,45,20,2.9959,1.5077,105,1.4882,0.5803,24131077,24131098
0.5,0.3909,1.69,65,45,45,20,2.9928,1.4359,110,1.5569,0.578,24131098,24131120
0.5207,0.3884,1.6263,85,35,60,25,2.9959,1.4964,120,1.4995,0.5606,24131120,24131144
0.5168,0.3815,1.885,80,50,55,25,3.2728,1.56,130,1.7128,0.5619,24131144,24131170
0.5412,0.3795,1.6367,80,25,60,20,3.0052,1.6912,105,1.3139,0.5516,24131170,24131191
0.5296,0.3596,1.8951,90,35,45,45,3.3162,1.6263,125,1.6899,0.5601,24131191,24131216
0.4892,0.4172,1.56,75,40,50,25,2.8027,1.2367,115,1.5659,0.5451,24146188,24146211
0.4975,0.3675,1.3665,70,45,50,20,2.6162,1.2367,115,1.3795,0.5556,24168040,24168063
0.4627,0.3875,1.5654,65,45,45,20,2.6726,1.3016,110,1.371,0.553,24168063,24168085
0.5109,0.515,1.695,65,45,40,25,3.0564,1.2367,110,1.8196,0.5403,24168085,24168107
0.4992,0.418,1.82,60,35,45,15,2.8674,1.5614,95,1.306,0.5294,24168107,24168126
0.4877,0.4589,1.7598,70,40,50,20,3.0686,1.4315,110,1.6371,0.5366,24168126,24168148
0.5331,0.4148,1.625,80,25,50,30,2.9265,1.4964,105,1.4301,0.5545,24168148,24168169
0.5101,0.4466,1.695,65,20,55,10,2.9309,1.56,85,1.3709,0.5618,24168169,24168186
0.5206,0.3817,2.016,70,35,50,20,3.1214,1.495,105,1.6264,0.5469,24168186,24168207
0.5101,0.3188,1.8861,80,60,50,30,2.8148,1.3712,140,1.4436,0.57,24244050,24244078
0.498,0.35,1.7598,80,30,50,30,2.8747,1.4359,110,1.4388,0.5742,24244078,24244100
0.5,0.3072,1.7562,70,40,50,20,2.4836,1.4315,110,1.0522,0.5677,24244100,24244122
0.5425,0.3652,1.8246,70,65,45,25,2.8979,1.2418,135,1.6561,0.5504,24244122,24244149
0.4896,0.3563,1.8246,70,40,50,20,3.0564,1.5721,110,1.4843,0.5302,24244149,24244171
0.5089,0.2866,2.0192,75,55,50,25,3.0896,1.4964,130,1.5932,0.5557,24244171,24244197
0.5323,0.3379,1.6263,80,35,50,30,2.7305,1.3665,115,1.3639,0.5732,24251043,24251066
0.5199,0.3559,1.495,70,35,60,10,2.6286,1.4534,105,1.1752,0.5839,24251066,24251087
0.4633,0.3561,1.7562,80,50,55,25,2.8093,1.3665,130,1.4427,0.5777,24251087,24251113
0.4776,0.3422,1.625,75,60,55,20,2.8615,1.3016,135,1.5599,0.5855,24251113,24251140
0.5008,0.3369,1.6912,70,55,50,20,2.7377,1.3665,125,1.3712,0.5821,24251140,24251165
0.5228,0.3705,1.695,80,40,55,25,2.738,1.3712,120,1.3668,0.5727,24251165,24251189
0.5339,0.3439,1.8304,75,50,45,30,2.8029,1.4315,125,1.3714,0.5731,24251189,24251214